src_segmentnr	src_original	tgt_segmentnr	tgt_original
GK17jvrtmspu:1	 vṛttaṃ samam ardhasamaṃ viṣamaṃ cety āmananti vāgīśaḥ /	T12D4305:379b-6	སྤྱོད་ཚུལ་མཉམ་དང་ཕྱེད་མཉམ་མི་མཉམ་པ་༎
GK17jvrtmspu:100	 anantarodbhāvitalakṣaṇāḍhyau pādau bhavetām api gocarau te /	T12D4305:381b-11	ཁྱོད་ཀྱི་ཞབས་དག་མཉན་འོས་བགྲོད་པ་སྤྲོས་པ་ཡང་༎
GK17jvrtmspu:101	 yāsāṃ dṛśaḥ śravyayatiprapañcau dhanyāḥ surāṇām upajātayas tāḥ // JVms_50 //	T12D4305:381b-12	གང་དག་རྣམས་ཀྱི་མིག་གི་སྤྱོད་ཡུལ་དུ་གྱུར་པ་༎ དེ་དག་ལྷ་རྣམས་ཉེ་བའི་རིས་ཏེ་བསྔགས་པར་འོས་༎
GK17jvrtmspu:102	 asaṃśayaṃ tvām apareṣu satsv api prakāmasarvātmaguṇānuhāriṣu /	T12D4305:381b-14	རབ་འདོད་བདག་ཉིད་ཡོན་ཏན་ཐམས་ཅད་རྗེས་སུ་འཕྲོག་བྱེད་༎ གཞན་དག་ཡོད་པར་གྱུར་ཀྱང་ཐེ་ཚོམ་མེད་པར་ཁྱོད་ནི་༎ གཞན་དང་ཐུན་མོང་མིན་པའི་བློ་གྲོས་དག་གི་བདག་པོ་༎ ལུས་མེད་དག་ལས་རྒྱལ་བ་རིགས་ལ་གནས་པར་གསུང་ངོ་༎ བྱིས་པའི་དབྱིབས་ཅན་མཛེས་ཤིང་རྣམ་པར་བཀྲ་བའི་རྒྱན་ལྡན་༎
GK17jvrtmspu:104	 bālākṛtiṃ kāntavicitrabhūṣaṇaṃ hemābham akṣobhyasanāthaśekharam /  vāgīśvaraṃ vāgmatimūrtibhir name maunīndravaṃśābharānodayaśriyam // JVms_52 //	T12D4305:381b-19	གསེར་གྱི་མདོག་ཅན་མི་འཁྲུགས་ཅོད་པན་དག་དང་བཅས་ཤིང་༎ ཐུབ་དབང་རིགས་ཀྱི་རྒྱན་ནི་འབྱུང་བ་དག་གི་དཔལ་གྱུར་༎ ངག་གི་དབང་ཕྱུག་ལ་ནི་ངག་བློ་ལུས་ཀྱིས་འདུད་དོ་༎ ཚིག་བཟང་རྣམས་ཀྱི་ཚིག་ནི་ཤིན་ཏུ་མང་པོ་ཡིས་ཀྱང་༎ ལྷག་པའི་མགོན་པོ་ཁྱོད་ཀྱི་ཡོན་ཏན་ཕ་རོལ་མ་ཕྱིན་༎
GK17jvrtmspu:106	 ativistarair api girāṃ sugiro guṇapāram īyur adhinātha na te /  nijamodamātrajananīti nutiḥ pramitākṣarāpi subhagaiva mama // JVms_53 //	T12D4305:381b-24	བདག་གི་སྟོན་པ་རབ་ཏུ་ཉུང་བ་འདི་ཡང་༎ རང་ཉིད་དགའ་བ་ཙམ་བསྐྱེད་སྐལ་བ་བཟང་པོ་ཉིད་དོ་༎
GK17jvrtmspu:108	 dīpyamānākhilālaṅkṛtiślāghinī puṇyabhājāṃ mukhāmbhojalabdhodayā /  bhāratī bhāratīśa svabhāvojjvalā tvām upaiti svayaṃ sadguṇasragviṇī // JVms_54 //	T12D4305:381b-26	དབྱངས་ཅན་དབང་པོ་ཁྱོད་ལ་དབྱངས་ཅན་ཡོན་ཏན་རབ་འབར་༎ གསལ་ལྡན་མ་ལུས་རྒྱན་རྣམས་དག་གིས་བསྔགས་པར་འོད་ལྡན་༎ བསོད་ནམས་བསྟེན་པའི་ཞལ་གྱི་ཆུ་སྐྱེས་ལས་ནི་འབྱུང་རྙེད་༎ དམ་པའི་ཡོན་ཏན་ཕྲེང་ལྡན་རང་ཉིད་ཉེ་བར་བསྟེན་ཏོ་༎
GK17jvrtmspu:110	 bhaṅgaṃ nītās te pañcabāṇasya bāṇāḥ śānto dveṣāgnir mohajāḍyaṃ nirastam /	T12D4305:381b-30	མདའ་ལྔ་པ་ཡི་མདའ་དེ་དག་ནི་བཅོམ་པ་དག་དང་༎ ཞེ་སྡང་མ་དག་གླན་ཞིང་རྨོངས་པའི་བླུན་པ་ངེས་སེལ་༎
GK17jvrtmspu:111	 nātha trailokyānugrahavyagramūrte saṃpat saṃprāptā vaiśvadevī tvayaiva // JVms_55 //	T12D4305:381b-31	མགོན་པོ་འཇིག་རྟེན་གསུམ་པོ་རྗེས་འཛིན་གྱིས་འབྲེལ་གཟུགས་ཅན་༎ ཁྱོད་ཉིད་ཀྱི་ནི་མཐུ་ལས་ཡོན་ཏན་སྣ་ཚོགས་ལེགས་ཐོབ་༎
GK17jvrtmspu:112	 saṃpūrṇo 'ntar guṇagaṇaratnaiś citrair ambhorāśer yatim atidhairyād dhatse /	T12D4305:382a-0	ཤིན་ཏུ་བརྟན་ལས་ཡོན་ཏན་ཚོགས་ཀྱི་རིན་ཆེན་བཀྲ་༄༣༨༢ཨ་༌་༎
GK17jvrtmspu:113	 saṃkleśāgnipraśamanasaddharmāmbho-dhārāsārair jaladharamālālīlām // JVms_56 //	T12D4305:382a-1	བས་༏་། ནང་གི་ཡོངས་སུ་གང་བས་ཆུ་ཡི་ཕུང་པོའི་ལུགས་དང་༎ ཀུན་ནས་ཉོན་མོངས་མེ་རབ་ཞི་བྱེད་དམ་ཆོས་ཆུ་ཡི་༎ ཆར་རྒྱུན་དག་གིས་ཆུ་འཛིན་ཕྲེང་བའི་རོལ་བ་འཛིན་ནོ་༎
GK17jvrtmspu:114	 tava puraḥ paramottama saṃmatāḥ pratibhayā vikalāḥ prativādinah /	T12D4305:382a-3	ཁྱོད་ཀྱི་མདུན་དག་ཏུ་ནི་མཆོག་དང་དམ་པར་རབ་འདོད་༎ སྤོབས་པ་དག་དང་བྲལ་བའི་ཕྱིར་ལ་སྨྲ་བ་པོ་རྣམས་༎
GK17jvrtmspu:115	 sulabhamūkadaśā bahu manyante drutavilambitam apy uditaṃ vacaḥ // JVms_57 //	T12D4305:382a-5	མྱུར་བ་དང་ནི་བུལ་བར་བརྗོད་པའི་ཚིག་རྣམས་དག་ཀྱང་༎ ལྐུགས་པའི་གནས་སྐབས་དག་ནི་རྙེད་སླར་མང་དུ་བཞེད་དོ་༎
GK17jvrtmspu:116	 tritayam api pavitrayantī jagat tuhinakarakarāvadātadyutiḥ /	T12D4305:382a-7	འགྲོ་བ་གསུམ་པོ་དག་ཀྱང་གཙང་མ་ཉིད་དུ་བྱེད་ཅིང་༎ བསིལ་ཟེར་ལྡན་པའི་ཟེར་ལྟར་རབ་ཏུ་དཀར་བའི་འོད་ཅན་༎ གྲགས་པ་དག་ནི་ཡུན་རིང་གནས་པ་ཁྱོད་ལས་འབྱུང་སྟེ་༎ ལྷ་ཡི་རི་རྩེ་ལས་ཀྱང་དལ་གྱིས་འབབ་པ་དག་གོ་༎
GK17jvrtmspu:118	 harati nitāntam iyaṃ tava kīrtiḥ kṛtihṛdayāni dayānijavāsa /	T12D4305:382a-11	བརྩེ་བ་དག་གི་རང་གནས་ཁྱོད་ཀྱི་གྲགས་པ་འདི་ཡིས་༎ མཁས་པ་དག་གི་སྙིང་ནི་ཤིན་ཏུ་འཕྲོག་པར་བགྱིད་དེ་༎
GK17jvrtmspu:119	 prasavacayena citeva samantād diśi diśi kundalatā dalatālam // JVms_59 //	T12D4305:382a-13	ཕྱོགས་ཕྱོགས་དག་ཏུ་ཀུནདའི་འཁྲི་ཤིང་ཀུན་ནས་རབ་ཏུ་༎ རྒྱས་པའི་མེ་ཏོག་ཚོགས་ནི་བསགས་པ་དག་གི་བཞིན་ནོ་༎
GK17jvrtmspu:121	 bahubuddhakoṭinirmāṇapaṭīyān dhṛtadharmadhātuvāgīśvaralīlaḥ // JVms_60 //	T12D4305:382a-15	ཆོས་དབྱིངས་གསུང་གི་དབང་ཕྱུག་དག་གི་རལ་བ་འཛིན་ཅིང་༎ སངས་རྒྱས་མང་པོ་བྱ་བ་སྤྲུལ་པ་ལ་ནི་མཁས་གྱུར་༎ བརྩེ་བའི་ཆུ་གཏེར་མཛེས་པའི་ཚོགས་པ་ཉེ་བར་འཛིན་པ་༎ སུ་ཞིག་འདི་ནི་འགྲོ་བ་རྣམས་ཀྱི་སྡིག་པ་འཇོམས་སོ་༎
GK17jvrtmspu:122	 pravikiratīva viyattaraṅgiṇī-taralataraṅgaruco rucāṃ cayān /	T12D4305:382a-19	མཁའ་ཡི་རླབས་ལྡན་དག་གི་ག-ཡོ་བའི་རླབས་ཀྱི་འོད་ནི་༎ འོད་ཟེར་ཚོགས་ལ་རྣམ་པར་རེག་པར་གྱུར་བ་བཞིན་དུ་༎
GK17jvrtmspu:123	 vilasati śaśvad asir daśāntare tava yamunājalavīcimecakaḥ // JVms_61 //	T12D4305:382a-21	ཡ་མུ་ནི་ཡ་ཆུ་ཡི་དབའ་རླབས་ལྟ་བུར་སྔོ་བ་༎ ཁྱོད་ཀྱི་རལ་གྲི་སྐབས་གཞན་དག་ཏུ་རྣམ་རོལ་༎
GK17jvrtmspu:125	 kva tac cātidurdāntasattvapraśāntyai sphuradbhīmabhūṣābhujaṅgaprayātam* // JVms_62 //	T12D4305:382a-28	ཤིན་ཏུ་གདུལ་དཀའི་སེམས་ཅན་ཞི་བའི་ཆེད་དུ་འཕྲོ་བའི་༎ འཇིགས་རུང་རྒྱུན་ཆ་ལག་འགྲོ་རབ་ཏུ་ཐོབ་པའང་གང་ན་༎
GK17jvrtmspu:126	 aviralamauktikaprakarabhūṣā harati na kasya cittam iyam īśa /  suruciramallikāsamayasevya-pratinavamālinīva tava mūrtiḥ // JVms_63 //	T12D4305:382a-30	དབང་པོ་བར་མཚམས་མེད་པའི་མུ་ཏིག་རྣམས་ཀྱི་ཚོགས་ཀྱིས་༎ བརྒྱན་པ་ཁྱོད་ཀྱི་སྐུ་འདི་རབ་༄༣༨༢བ་མཛེས་མ་ལའི་ཀཤ་ཡི་༎ དུས་སུ་བསྟེན་པ་འོས་པ་མེ་ཏོག་ཕྲེང་བ་གསར་བ་༎ ལྡན་པ་ལྟ་བུར་སུ་ཡི་སྙིང་ནི་འཕྲོག་པར་མི་བྱེད་༎
GK17jvrtmspu:128	 tava nātha paraṃ yadi kāntisudhā-jaladhau śramam ujjhati jhātkṛtini /	T12D4305:382b-3	མགོན་པོ་ཀབ༹་ཡེ་གལ་ཏེ་ཁྱོད་ཀྱི་མཛེས་པ་བདུད་རྩིའི་། ༎ ཆུ་གཏེར་རླབས་ཆེན་བྱས་པར་ངལ་བ་མཆོག་ཏུ་སྟོན་ན་༎
GK17jvrtmspu:129	 śubharūpanirūpaṇalampaṭakaṃ parito 'ṭakam aṅga jagannayanam // JVms_64 //	T12D4305:382b-5	འགྲོ་བའི་མིག་ནི་རབ་ཏུ་མཛེས་པར་རྟོགས་པར་བྱེད་པར་༏་། མངོན་པར་འདོད་པ་དག་དང་ལྡན་པར་འགྲོ་བར་བྱེད་དོ་༎
GK17jvrtmspu:130	 varada viratibhāñji vyaktam aṅgāny atibhava bhavitā no 'vaśyam eva /	T12D4305:382b-7	མཆོག་སྦྱིན་སྲིད་ལས་འདས་པར་བདག་གི་ཡན་ལག་རྣམས་ནི་༎
GK17jvrtmspu:131	 tava vacanasudhāyāḥ pānapātraṃ śravaṇayugapuṭo 'yaṃ prītihetuḥ // JVms_65 //	T12D4305:382b-10	སྣོད་གྱུར་རྣ་བ་ཟུང་སྤྱར་པ་འདི་དགའ་བའི་རྒྱུའོ་༎
GK17jvrtmspu:132	 vṛṇe varam imaṃ tvad ekam atula-prabhāva bhavatān na mādṛśajanaḥ /	T12D4305:382b-11	མཐུ་སྟོབས་མཉམ་པ་མེད་པ་གང་ཞིག་ཁྱོད་ལ་བསྟེན་ཡང་༎
GK17jvrtmspu:133	 bhavantam api yah śrayañ chamasudhā-raseṣu viratir jaḍoddhatagatiḥ // JVms_66 //	T12D4305:382b-12	ཞི་བའི་བདུད་རྩི་བཅུད་རྣམས་ལ་ནི་དགའ་དང་བྲལ་བ་༎ བླུན་པོ་ག-ཡེངས་པའི་བློ་ཅན་བདག་ལྟ་བུ་ཡི་སྐྱེ་བོ་༎
GK17jvrtmspu:134	 tvatprasādasamudīrṇaśubhavaśād aṣṭabhedi sukham eva kṛtijanaḥ /	T12D4305:382b-14	མི་འབྱུང་འགྱུར་བའི་རབ་མཆོག་གཅིག་པོ་འདི་ནི་ཁྱོད་ལ་སློང་ངོ་༎ ལུས་འཛིན་རྣམས་ཀྱི་མིག་གི་དགའ་སྟོན་སྒྲུབ་ལ་ཟླ་བ་༎ ཁྱོད་ཀྱི་དྲིན་གྱིས་དགེ་བ་ཡང་དག་རྒྱས་པའི་དབང་ལས་༎
GK17jvrtmspu:136	 sukhaduḥkhātiśayādihetujātair aviluptasmṛtayo bhavanti bhavyāḥ /  tava pādāśrayalabdhabuddhisārāḥ sakalāyām api vādirāja gatyām // JVms_68 //  tava caraṇaparicaraṇarucīnāṃ kim api sukham udayati kṛtirūpam /  nikhilamalapaṭalavigamadīpraṃ prathitaguṇamahitamati jagatyām // JVms_69 //	T12D4305:382b-24	མ་ལུས་དྲི་མའི་ཚོགས་དང་བྲལ་ལས་གསལ་བའི་ངང་ཚུལ་ཅན་༎ རབ་ཏུ་རྒྱས་པའི་ཡོན་ཏན་དག་གིས་ཆེ་བའི་བློ་གྲོས་དག་། ཕུན་ཚོགས་རང་བཞིན་བདེ་བ་ཅི་ཡང་འགྲོ་བར་སྐྱེད་པར་བྱེད་༎
GK17jvrtmspu:140	 kaladhautakāntavapur uttamalīlaḥ paṭubhāratīvaraṭayā varivasyaḥ /	T12D4305:382b-26	དག་པར་བྱས་པའི་གསེར་ལྡན་མཛེས་པའི་སྐུ་ཅན་མཆོག་ཏུ་སྒེག་། གསལ་བའི་གསུང་གི་ངང་མོ་རྣམས་ཀྱིས་བསྟེན་བྱ་རྒྱལ་བ་ཡི་༎
GK17jvrtmspu:141	 iha mañjughoṣa iti vaḥ prathito vyāj jinamānasaikanalinīkalahaṃsaḥ // JVms_70 //	T12D4305:382b-27	ཡིད་མཚོར་པད་སྡོང་ལྡན་པ་གཅིག་པོར་ངང་པ་སྙན་སྒྲོགས་ཏེ་༎ འཇམ་པའི་དབྱངས་ཞེས་གྲགས་པས་འདིར་ནི་ཁྱོད་ལ་བསྲུང་གྱུར་ཅིག་། མགོན་པོ་བཟོད་པར་དཀའ་བའི་ཉོན་མོངས་འདི་གསུམ་རྣམས་ལ་ནི་༎
GK17jvrtmspu:142	 vicchedas triṣu yadi duḥsaheṣv amīṣu kleśeṣu sphuṭam aṇuśo 'pi duṣkaraḥ syāt /	T12D4305:382b-29	རྣམ་པར་དཔྱོད་པ་ཕྲ་མོ་དག་ཀྱང་གལ་ཏེ་བྱ་དཀའ་བར་༎
GK17jvrtmspu:143	 prāpyeta kva nu khalu nātha mūrtir īdṛk trailokīnayanamanaḥpraharṣiṇīha // JVms_71 //	T12D4305:382b-30	གསལ་བར་འགྱུར་ན་འཇིག་རྟེན་གསུམ་པོ་འདིར་ནི་མིག་དང་ཡིད༎ ༄༣༨༣ཨ་༌་༎ དགའ་བྱེད་སྐུ་འདི་འདྲ་བ་ཐོབ་པ་ངེས་པར་གང་ན་ཞིག་། ཆེ་བའི་འོད་ཟེར་འཕྲོ་བའི་རིན་ཆེན་ཚོགས་རྣམས་འཛིན་པ་ཡི་༎
GK17jvrtmspu:144	 payonidhau viratim apāṃ vidhāya ca sphuranmahākiraṇakalāparatnadhau /	T12D4305:383a-1	ཆུ་ཡི་གཏེར་དུ་ཆུ་རྣམས་རྣམ་པར་གསལ་བར་བྱས་ནས་ནི་༎
GK17jvrtmspu:145	 bhavādṛśāṃ vapuṣi ca kāntisaṃtatiḥ samīkṣyate yadi rucireyam īdṛśī // JVms_72 //	T12D4305:383a-2	གལ་ཏེ་ངེས་པར་བལྟ་བར་གྱུར་ན་ཁྱོད་ལྟ་བུ་རྣམས་ཀྱི་༎ སྐུ་ལ་མཛེས་པའི་རྒྱུན་ནི་རབ་མཛེས་འདི་ལྟ་བུ་འདི་ཡང་༎
GK17jvrtmspu:146	 mandradhvānair yāmṛtadhārās tvayi ramyā muñcaty uccair visphurati prīṇitabhavye /	T12D4305:383a-4	མགོན་པོ་ཟབ་མོའི་སྒྲ་དབྱངས་མཐོན་པོ་རྣམས་ཀྱིས་ཁྱོད་ལ་གང་༎ ཡིད་འོང་བདུད་རྩིའི་རྒྱུན་རྣམས་འབེབས་བྱེད་དགའ་དང་སྐལ་བཟང་དག་། སྤྲོ་བྱེད་སྤྱོད་ཚུལ་ཤིན་ཏུ་ཡིད་འོང་དབྱར་གྱི་ཚུ་འཛིན་གྱི་༎ རྗེས་སུ་གསལ་བར་འགྲོ་སྟེ་དེ་ཉིད་རྨ་བྱ་མྱོས་བྱེད་ཀྱང་༎
GK17jvrtmspu:148	 jayatīyam utpalataror anuttara-trijagatpramodajanane madhāv iva /	T12D4305:383a-7	དཔྱིད་ཟླ་བཞིན་དུ་ཁྱོད་ལ་འགྲོ་བ་གསུམ་པོ་རབ་དགའ་བ་༎ མཛེས་པའི་མེ་ཏོག་གིས་མཐོང་སྦྲང་རྩིས་མྱོས་པ་བུང་བ་ཡི་༎
GK17jvrtmspu:149	 tvayi netrakāntakusumodgatā latā madhumattabhṛṅgaravamañjubhāṣiṇī // JVms_74 //  sarvātiśāyiguṇanirbharalabdhamodair vidvanmadhuvratakulair upagīyamānam /	T12D4305:383a-10	སྒྲ་རྣམས་འཇམ་པའི་དབྱངས་བྱེད་ཚུལ་ཅན་འདི་ཡིས་རྒྱལ་གྱུར་ཅིག་། ཁྱད་པར་འཕགས་པའི་ཡོན་ཏན་ཀུན་གྱིས་དགའ་བ་མཆོག་རབ་ཐོབ་པ་ཡི་༎
GK17jvrtmspu:151	 manyāmahe jinanayābharaṇaṃ tavaiva vṛttaṃ vasantatilakaṃ navacūtam eva // JVms_75 //	T12D4305:383a-12	རྒྱལ་བའི་ལུགས་ཀྱི་རྒྱན་དུ་གྱུར་པ་ཁྱོད་ཀྱི་སྤྱོད་ཚུལ་ཁོ་ན་༎ དཔྱིད་ཀྱི་ཐིག་ལེ་ཙའུ་ཏ་གསར་པ་དག་ནི་མིན་ནམ་སྙམ་མོ་༎
GK17jvrtmspu:152	 saṃmukhavalanmukhamṛgādhipatipṛṣṭhā-rūḍham atigāḍhadayam abhyudayakandam /  sundarimabandhuritahemahimapādaṃ vādikuladaivatam amandam abhivande // JVms_76 //  praśamitasakalaprapañcanirāvṛti-prasaradamaladhīsamādhisudhājuṣaḥ /	T12D4305:383a-14	གདོང་པ་བསྐྱོགས་པས་གདོང་ཕྱོགས་རི་དགས་བདག་པོའི་རྒྱལ་ལ་བཅིབས་པ་༎ ཐུགས་རྗེས་ཤིན་ཏུ་མཆོག་ཏུ་གྱུར་ཅིང་མངོན་པར་མཐོ་བའི་རྩ་བ་༎ རབ་ཏུ་མཛེས་པ་ཉིད་ཀྱིས་གསེར་དང་ཁ་བའི་རྐང་བ་བཟུང་བ་༎ སྨྲ་བའི་རིགས་ཀྱི་ལྷ་ཉིད་ལ་ནི་དལ་བུ་མིན་པར་ཕྱག་འཚལ་༎ སྤྲོས་པ་མཐའ་དག་རབ་ཏུ་ཞི་བར་གྱུར་དང་སྒྲིབ་པ་མེད་པས་༎ རབ་ཏུ་རྒྱས་པའི་བློ་དང་ཏིང་ངེ་འཛིན་གྱི་བདུད་རྩི་བསྟེན་པ་༎
GK17jvrtmspu:155	 damayati bhavato hatāhitavikramā muniyatir aparājitā bhuvanatrayam // JVms_77 //	T12D4305:383a-20	ཁྱེད་ཀྱི་ཐུབ་པའི་སྤྱོད་ཚུལ་མི་ཕན་འཇོམས་པའི་རྣམ་པར་གནོན་པས་༎ གཞན་གྱིས་མི་ཐུབ་པ་ཡི་སྲིད་པ་གསུམ་རྣམས་འདུལ་བར་བྱེད་དོ་༎
GK17jvrtmspu:156	 pratibhayavapuṣām akaruṇacarita-praśamanavidhaye kva cid api kṛpayā /	T12D4305:383a-22	རབ་ཏུ་འཇིགས་སུ་རུང་བའི་ཡུལ་ཅན་རྣམས་ཀྱི་བརྩེ་བ་མེད་པའི་༎ སྤྱོད་པས་རབ་ཏུ་ཞི་བ་སྒྲུབ་པའི་ཆེད་དུ་འགའ་ཞིག་ཏུ་ཡང་༎
GK17jvrtmspu:157	 tava bhujaparighāvalir ativiṣamā vilasati vividhapraharaṇakalikā // JVms_78 //	T12D4305:383a-24	ཐུགས་རྗེས་ཁྱོད་ཀྱི་ཕྱག་གི་ཡོངས་འཇོམས་ཕྲེང་བ་བཞིན་དུ་འཇིགས་རུང་༎ རྣམ་པ་སྣ་ཚོགས་མཚོན་ཆ་སྒྲོགས་པར་བྱེད་རྣམས་རྣམ་པར་རོལ་ལོ་༎
GK17jvrtmspu:158	 śreyaḥsaṃbhogaṃ viṣayaviratim avyagrāṃ mārapradhvaṃsaṃ tribhuvanahitasaṃpattim /	T12D4305:383a-26	མཆོག་སྦྱིན་དགེ་ལེགས་ལོངས་སྤྱོད་དང་ནི་ཡུལ་ལ་ཆགས་པ་བྲལ་བ་༎ འཁྲུལ་བ་མེད་དང་བདུད་རབ་འཇོམས་དང་སྲིད་གསུམ་ལ་ཕན་ཕུན་སུམ་༎
GK17jvrtmspu:159	 duṣprāpāhāryaṃ padam abhilaṣatāṃ tac ca tvadbhakter anyā varada na dig asaṃbādhā // JVms_79 //	T12D4305:383b-0	ཚོགས་༄༣༨༣བ་པའི་གོ་འཕང་ཐོབ་དཀའ་མི་འཕྲོགས་མངོན་པར་འདོད་པ་རྣམས་ཀྱི་༎ དེ་ཡང་ཁྱེད་ལ་གུས་པ་ལ་སྟེ་ལམ་གཞན་གནོད་མེད་མེད་དོ་༎
GK17jvrtmspu:160	 bhavataḥ kalāṃ kim api saṃyatair indriyaiḥ kva cid ādarastimitadhīr yadi dhyāyati /	T12D4305:383b-2	གལ་ཏེ་དབང་པོ་རྣམས་ནི་བསྡམས་པས་འགའ་ཞིག་དག་ཏུ་གུས་པ་༎ ག-ཡོ་བ་མེད་པའི་བློ་ཅན་ཁྱོད་ཀྱི་ཆ་ཤས་ཅི་ཡང་བསྒོམས་ན་༎
GK17jvrtmspu:161	 acirāt svayaṃ varayatīyam enaṃ janaṃ vasudhā dhruvaṃ jaladhiśakvarībhūṣaṇā // JVms_80 //  svedapūravilasatpulakocchvasitais truṭat-kañcukaṃ dadhati nirdhutam apy amarastriyaḥ /  kāntikamram iva te samitāv atiśakvarī-bandhasāram urukampam anaṅgavijṛmbhitam // JVms_81 //	T12D4305:383b-4	སྐྱེ་བོ་འདི་ལ་རིང་བོར་མི་ཐོགས་ཆུ་གཏེར་སྐ་རགས་དག་གིས་༎ བརྒྱན་པའི་ནོར་འཛིན་འདི་ནི་རང་ཉིད་ངེས་པར་འདམ་པར་བྱེད་དོ་༎ ཁྱོད་ཀྱི་འདུན་སར་འཆི་མེད་བུད་མེད་རྣམས་ནི་ངེས་པར་ཡང་བྱས་ཀྱང་༎ མཆོག་ཏུ་ཐོན་པ་རྣམས་ཀྱི་ནུ་མ་གས་ཤིང་སྐ་རགས་ཆེས་ཆེར་བཅིངས་པ་ཡི་༎
GK17jvrtmspu:164	 anupamaramaṇīyā bhaṅgir aṅgeṣu yasyā harati ratim udārāśeṣarūpāntareṣu /  jayati tanur akhaṇḍākhaṇḍaleṣvāsalakṣmī-vijayaparamadhāmavyāmarugmālinīyam // JVms_82 //  avikalatālaśālikalakākalīkala-vyatikaravallakīvalitacārupañcamā /	T12D4305:383b-9	སྟོབས་ཅན་ཆེས་ཆེར་འདར་བའི་འདོད་ལྷའི་རྣམ་པར་བསྒྱིངས་པ་འཛིན་པར་བྱེད་༎ མཆོག་ཏུ་རྒྱ་ཆེའི་གཟུགས་གཞན་མ་ལུས་རྣམས་ལ་དགའ་བར་འཕྲོག་པར་བྱེད་༎ སྐུ་ལུས་ཉམས་པ་མེད་པ་དབང་པོའི་མདའ་རྟེན་རྣམ་པར་འདུལ་བ་ཡི་༎
GK17jvrtmspu:167	 bhaṇati mudā pratīṣṭajinabhāra bhāratī svamahimakāminī tava sabhāsu madrakam // JVms_83 //  jayati nātha jagajjayakuñjaraniścalī-karaṇaśṛṅkhalajālanibhāṅgadabhūṣitaḥ /	T12D4305:383b-13	གཞི་ཡི་མཆོག་རབ་སྣ་ཚོགས་འོད་ཟེར་ཕྲེང་བ་ལྡན་འདི་རྒྱལ་གྱུར་ཅིག་། རྒྱལ་བའི་ཁུར་བུ་ཞལ་གྱིས་མཆེས་པ་ཁྱོད་ཀྱི་འདུན་སར་དགའ་བ་ཡིས་༎
GK17jvrtmspu:170	 bhavaśirasi mahitaguṇamahimabhuvaṃ vyapagatasakalamalaśucim adhipate /	T12D4305:383b-19	བདེ་བར་གཤེགས་པའི་དགའ་བ་ཁྱོད་ཀྱི་ཕྱག་གི་ལྗོན་ཤིང་རྒྱལ་གྱུར་ཅིག་། བདག་པོ་ཁྱོད་ཀྱི་མཆོག་ལས་རྣམ་པར་རྒྱལ་བས་ཡང་དག་བསགས་པ་ཡི་༎ གྲགས་པའི་དཔལ་ནི་སྲིད་པའི་སྤྱི་བོར་ཆེ་བའི་ཡོན་ཏན་ཕུན་ཚོགས་པ་༎
GK17jvrtmspu:184	 kas tvayi baddhavarmaṇi jagaddhitadhānadhiyā nirvihatapratijña paritāpakaṇaḥ kva cana /	T12D4305:384a-21	འགྲོ་ལ་ཕན་པ་བསྒྲུབ་པར་བྱ་བའི་བློ་ཡིས་གོ་ཆ་བཅིངས་པ་ཁྱོད་ལ་༎ ཡོངས་གདུང་ཕྲ་མོ་གང་ནའང་ཅི་ཞིག་ཀབ༹་ཡེ་དམ་བཅས་ཉམས་པ་མེད་པ་༎
GK17jvrtmspu:185	 māravadhūjanasya kamanīyakapolatale yan navapattrabhaṅgaracanālasa eva karaḥ // JVms_92 //	T12D4305:384a-23	གང་ཕྱིར་བདུད་ཀྱི་ཆུང་མའི་སྐྱེ་བོའི་ལག་པ་དག་ནི་འདོད་པར་འོས་པའི་༎ འགྲམ་པའི་གཞི་ལ་མཁུར་རྩི་གསར་པ་འགོད་པར་བྱེད་ལ་ལེ་ལོ་ཁོ་ནའོ་༎
GK17jvrtmspu:186	 nirupamaramyarūpa jinajātadṛśvano 'ṣṭau madayati te 'dhikaṃ vidhutaśoka lokapālān /	T12D4305:384b-0	དཔེ་མེད་༄༣༨༤བ་དགའ་འོས་གཟུགས་ཅན་མྱ་ངན་རྣམ་པར་བསལ་བའི་རྒྱལ་བའི་ཚོགས་རྣམས་༎
GK17jvrtmspu:187	 sadupadhipuṇḍarīkanakharājirājiteyaṃ viracitapañcacīrarucirā kumāralīlā // JVms_93 //	T12D4305:384b-1	གཟིགས་པ་ཁྱོད་ཀྱི་གཞོན་ནུའི་རོལ་པ་གསེར་བཟང་གིས་ནི་སྟག་གི་སེན་མོའི་༎ རི་མོ་བྲིས་ཤིང་རབ་མཛེས་ཟུར་ཕུད་ལྔ་རྣམས་རྣམ་པར་བཀོད་པར་བྱས་པ་༎ འདི་ཡིས་འཇིག་རྟེན་སྐྱོང་བ་བརྒྱད་པོ་རྣམས་ནི་ལྷག་པར་དགའ་བར་མཛད་དོ་༎
GK17jvrtmspu:188	 guṇānām atyaṣṭiḥ katham iha mamevāstu jagatām iti cchandaḥ svairaṃ pariṇatim avāpat tava tathā /  yathā tvayy evāsmin paramarasabhedapraṇayanī samudbhūtā bhūtir nikhilasukhaśākhāśikhariṇī // JVms_94 //	T12D4305:384b-4	ཇི་ལྟར་འདིར་ནི་ཁྱོད་ཁོ་ན་ལ་མཆོག་གི་ཉམས་ཀྱི་ཁྱད་པར་རབ་འདོད་པའི་༎ འབྱོར་པ་མ་ལུས་བདེ་བའི་ཡལ་གའི་རྩེ་མོ་ལྡན་པ་ཡང་དག་འབྱུང་འགྱུར་བ་༎ དེ་ལྟར་བདག་གིས་ཡོན་ཏན་རྣམས་ཀྱིས་ཤིན་ཏུ་ཁྱབ་པ་ལྟ་བུར་འགྲོ་རྣམས་ཀྱི་༎ ཅི་ཞིག་ལྟར་གྱུར་ཅིག་ཅེས་ཁྱོད་ཀྱི་འདུན་ས་དལ་བུས་འདིར་ནི་ཡོངས་སྨིན་གྱུར་༎
GK17jvrtmspu:190	 jayaty amaramandiropalaviśālarakṣaḥsthalaḥ sthalīkamalakānanapratimapādakandaprabhaḥ /  prabhākaraśatādhikaprakaṭatejasālaṅkṛtaḥ kṛtāntamadamardanas tribhavanāthapṛthvīdharaḥ // JVms_95 //  vimohabahalāndhakārapaṭalāvanaddhair mudhā rasātalaguhātiśāyibhavasaṃkaṭeṣu sthitam /	T12D4305:384b-8	འཆི་མེད་རི་བོའི་ལྟོ་བ་ལྟ་བུར་བྲང་གི་གཞི་ནི་རྣམ་པར་ཡངས་པ་ཅན་༎ ཞབས་ཀྱི་ཡལ་གའི་འོད་ཟེར་ཐང་ལས་སྐྱེས་པའི་པདམའི་ནགས་ཀྱི་གཟུགས་བརྙན་ཏེ་༎ སྣང་བར་བྱེད་པ་བརྒྱ་ཕྲག་རྣམས་ལས་ལྷག་པར་གསལ་བའི་གཟི་ཡིས་བརྒྱན་བྱས་པ་༎ མཐར་བྱེད་དྲེགས་པ་འཇོམས་བྱེད་སྲིད་གསུམ་མགོན་པོའི་ས་རྣམས་འཛིན་པ་རྒྱལ་གྱུར་ཅིག་། རྣམ་པར་རྨོངས་པ་རྒྱ་ཆེའི་མུན་པའི་ཚོགས་ཀྱིས་ངེས་པར་བཅིངས་པ་རྣམས་ཀྱིས་ནི་༎
GK17jvrtmspu:193	 tvadaṅghrikamalāśrayotsavasukhaṃ na ced ādṛtaṃ cirasya jinavaṃśabhāskara kumāra mārair jitam // JVms_96 //	T12D4305:384b-12	ཁྱོད་ཞབས་པདམ་དག་ནི་བསྟེན་པའི་དགའ་སྟོན་བདེ་ལ་གལ་ཏེ་མི་གུས་ན་༎
GK17jvrtmspu:2	 trividhaṃ parārthavidhaye samāsato vyāsato 'nantam // JVms_1 //	T12D4305:379b-7	ཞེས་པ་རྣམ་པ་གསུམ་ནི་བསྡུས་པ་སྟེ༎ རྒྱས་པ་ལས་ནི་མཐའ་ཡས་རབ་བསྟན་ཏོ་༎
GK17jvrtmspu:204	 śobhāsaṃpattiḥ śirasi guruṇaikena saivopajātā yā syāt kalpadroḥ śubhaphalanibhaṃ bibhrato bhadrakumbham /  [vyā]khyānapreṅkhatkarakararuhodbhāsinī bhāti bhartur dorvallī ceyaṃ kusumitalatā vellitevānilena // JVms_102 //	T12D4305:385a-12	མཛེས་པ་ཕུན་སུམ་ཚོགས་པར་གང་གྱུར་དེ་ཉིད་སྦྱི་བོར་བླ་མ་གཅིག་གིས་བསྐྱེད་དེ་༎ བཤད་པར་མཛད་པས་ག-ཡོབ་པའི་ཕྱག་གི་ཕྱག་སྐྱེས་རྣམས་ཀྱི་མཆོག་ཏུ་གསལ་བ་དཔུང་པའི་༎ ཡལ་ག་འདི་ནི་མེ་ཏོག་རྒྱས་པའི་འཁྲི་ཤིང་རླུང་གིས་ག-ཡོ་བ་ལྟ་བུར་སྣང་ངོ་༎
GK17jvrtmspu:206	 vṛttam etad aśeṣabuddhakulākalankakalānidher āhitaṃ hṛdi cen mahājaḍahārahāritavān asi /	T12D4305:385a-15	མ་ལུས་སངས་རྒྱས་རིགས་ཀྱི་རྙོག་པ་མད་པའི་ཆ་ཤས་གཏེར་གྱི་སྤྱོད་ཚུལ་འདི་རྣམས་༎ གལ་ཏེ་སྙིང་ལ་ཀུན་ནས་ཀུན་ན་གྲང་བ་ཆེན་པོའི་དོ་ཤལ་ཉམས་པར་འགྱུར་ཏེ་༎
GK17jvrtmspu:207	 jihvayā praṇayīti ced ghanasārasāramadena kiṃ karṇapūram akāri cet [khalu] khaṇḍitaṃ maṇikuṇḍalam // JVms_103 //	T12D4305:385a-17	གལ་ཏེ་ལྕེ་ཡིས་ཇི་ལྟར་འདོད་པར་བྱས་ན་སྦྲིན་གྱི་སྙིང་པོའི་གྲགས་པ་ཅི་ཞིག་། གལ་ཏེ་རྣ་བ་གང་བར་བྱས་པར་གྱུར་ན་ནོར་བུའི་རྣ་རྒྱན་ངེས་པར་བཅོམ་ལགས་༎
GK17jvrtmspu:208	 upacitapuṇyasaṃcaya śacīkaratalasukhadaiḥ paricaraṇair atṛptigam iva svam asamamahima[n] /  maṇimayapādapīṭhaphalakaṃ sphuṭayati bhavataḥ kalitatamālapattram alikān namati śatadhṛtau // JVms_104 //	T12D4305:385a-18	བསོད་ནམས་ཚོགས་རྣམས་ཉེ་བར་བསགས་པ་མཉམ་པ་མེད་པའི་བདག་ཉིད་ཆེན་པོ་ཁྱོད་ཀྱི་༎ ཞབས་གདན་ནོར་བུའི་རང་བཞིན་དག་གི་སྟེགས་ནི་བདེ་སོགས་ལག་པའི་མཐིལ་གྱི་བདེ་བ་༎ སྟེར་བའི་བསྙེན་བཀུར་བྱེད་པ་རྣམས་ཀྱིས་མ་ཚིམ་གྱུར་བ་བཞིན་དང་མཆོད་སྦྱིན་བརྒྱ་པ་༎ འདུད་པ་ན་ནི་མགོ་ལས་ཏའ་མ་ལ་ཡི་ལོ་མ་ཐོབ་སྟེ་རང་ཉིད་གསལ་ལོ༎
GK17jvrtmspu:210	 parārthe sthāsnūnām atidhṛtimatām īśa viśvānukampā-mukhonmīlannānārasarasapad ākarṇayāvedayāmi /	T12D4305:385a-22	གཞན་གྱི་དོན་ལ་གནས་པ་ཤིན་ཏུ་བརྟན་ལྡན་རྣམས་ཀྱི་དབང་པོ་སྣ་ཚོགས་ཐུགས་རྗེ་ཡི་༎
GK17jvrtmspu:211	 daśāṃ tām ādhehi kṣaṇam api guro pāvanīṃ pāvanānāṃ samantadhvāntāni praharasi yayā me 'ghavisphūrjitām // JVms_105 //	T12D4305:385a-23	སྒོ་ནས་འདུས་པའི་སྣ་ཚོགས་འདོད་ལྡན་ཉམས་ཀྱི་གནས་གྱུར་གསོན་ཅིག་བདག་གིས་རིགས་ལགས་སོ་༎ བླ་མ་གང་གིས་བདག་གི་སྡིག་པ་རྣམ་པར་བསྒྱིངས་པ་ཀུན་ནས་ནུན་པར་བྱེད་པ་རྣམས་༎ འཕྲོག་བྱེད་དག་བྱེད་རྣམས་༄༣༨༥བ་ཀྱི་དག་བྱེད་གནས་སྐབས་དེ་ནི་སྐད་ཅིག་ཙམ་ཡང་བསྒྲུབ་པར་མཛོད་༎
GK17jvrtmspu:212	 pāyād vo varabuddhavaṃśajaladher vṛddhau sudhādīdhitir mañjuśrīḥ paribhūtamanmathakathaḥ prajñāṅganāsaṃgame /	T12D4305:385b-1	རྒྱལ་བ་མཆོག་གི་རིགས་ཀྱི་ཆུ་གཏེར་འཕེལ་ལ་བཅུད་རྩིའི་འོད་ཅན་ཤེས་རབ་མཛེས་མ་དང་༎ འགྲོགས་ལ་ཡིད་སྲུབ་གཏམ་ལ་མི་གུས་འཇིགས་རུང་འཁྲུལ་པའི་མཚན་མོ་ཡོངས་སུ་འདུས་པ་ལ་༎
GK17jvrtmspu:213	 bhīmabhrāntivibhāvarīparibhave bibhrad yatiṃ bhāsvato viśvakleśakuraṅgasaṅgaravidhau śārdūlavikrīḍitam // JVms_106 //	T12D4305:385b-2	ཉི་མའི་བརྟུལ་ཞུགས་འཛིན་པ་སྣ་ཚོགས་ཉོན་མོངས་རི་དགས་ཡང་དག་འཇོམས་པ་སྒྲུབ་ལ་༎ སྟག་གིས་རྣམ་པར་རྩེན་པའི་དཔལ་ནི་ཁྱེད་རྣམས་དག་ལ་རྟག་ཏུ་བསྲུང་བར་གྱུར་ཅིག་། དྲི་མེད་སྟོན་ཀའི་ཟླ་བའི་འོད་ཀྱིས་ཡོངས་བསྐོར་ཟླ་བའི་གཟུགས་ལས་མ་ལུས་དགའ་བར་བྱ་ལ་༎
GK17jvrtmspu:214	 antastrāsāṅkurābhotpalitatanuruhais trailokyavijayā-vasthāṃ te vīkṣya bhagnaṃ suramunivisarair ugragrahanudaḥ /  kāruṇyād udyatasyāpy amalataraśarajjyotsnāparikarād indor bimbād anarghasmitavasuvadanāśeṣapriyakṛtau // JVms_107 //	T12D4305:385b-4	རིན་ཐང་མེད་པའི་འཛུམ་པའི་ནོར་ལྡན་ཞལ་ཅན་དྲག་པོའི་གདོན་རྣམས་གདུལ་བ་ཐུགས་རྗེ་ཉིད་ལས་༎ འབད་མཛད་ཁྱོད་ཀྱི་ཁམས་གསུམ་རྣམ་པར་རྒྱལ་བའི་གནས་སྐབས་ནང་གི་སྐྲག་པའི་མྱུ་གུ་ལྟ་བུར་༎ ལུས་སྐྱེས་ལང་ལོང་གྱུར་པའི་ལྷ་ཡི་ཐུབ་པའི་ཚོགས་རྣམས་དག་གིས་མཐོང་ནས་ཉམས་པར་གྱུར་ཏོ་༎
GK17jvrtmspu:216	 bhayabhagnair atidūrato virahiṇāṃ pattraiḥ śrayāyāyatām amarāṇāṃ gurubhaktinirbharamanovyaktau sahāyopamam /	T12D4305:385b-7	འཇིགས་པས་ཉམས་པའི་གཞོན་པ་རྣམ་དག་ཤིན་ཏུ་རིང་བར་བྲལ་ཞིང་བརྟན་བའི་ཆེད་དུ་འོངས་པའི་༎ འཆི་མེད་རྣམས་ཀྱི་གུས་པ་ལྕི་བ་ཁྱད་འཔགས་ཡིད་ནི་གསལ་བར་བྱེད་ལ་རྒྱུ་དང་འདྲ་བ་༎
GK17jvrtmspu:217	 gaganāmeyarayaṃ yugāntajaladadhvānādhikakṣveditaṃ paritaḥ khaṇḍitamāram astu jagatas tvatsiṃhavikrīḍitam // JVms_108 //  vyāptaviśvayā śarannabhastalātiśuddhayā dhiyādhiyāta-duḥsahārtiviklavāprameyasattvadhātvadhīnasatkṛpāḍhya /	T12D4305:385b-9	ཤུགས་སྟོབས་མཁའ་ལྟར་དཔག་ཏུ་མེད་པ་དུས་མཐའི་སྤྲིན་གྱི་སྒྲ་ལས་ལྷག་པའི་སེང་གེའི་སྒྲ་ཅན་༎ བདུད་རྣམས་ཡོངས་སུ་ཉམས་པར་བྱས་པ་ཁྱོད་ཀྱི་སེང་གེའི་རྣམ་པར་རོལ་པ་འགྲོ་ལ་གྱུར་ཅིག་། ཚོགས་རྣམས་ལ་ཁྱབ་སྟོན་ཀའི་ནམ་མཁའི་དཀྱིལ་ལྟར་ཤིན་ཏུ་དག་པའི་བློ་ཡི་ལྷག་པར་བསྟེན་པ་༎ བཟོད་དཀའི་གདུང་བས་འཁྲུགས་པའི་དཔག་མེད་སེམས་ཅན་ཁམས་ཀྱི་དབང་གྱུར་ཐུགས་རྗེ་དམ་པས་ཕྱུག་པ་༎
GK17jvrtmspu:219	 saṃsṛtau ca nirvṛtau ca śaśvadapratiṣṭhavādināṃ variṣṭha vṛttam īdṛśaṃ tu nāmato 'pi nāparasya siddhim abhyupeti // JVms_109 //	T12D4305:385b-12	ཡང་དག་བསྐྱེད་དང་མྱ་ངན་འདས་ལ་རྟག་ཏུ་མི་གནས་གསུང་ལྡན་རྣམས་ཀྱི་མཆོག་ཏུ་གྱུར་པ་༎ སྤྱོད་ཚུལ་འདི་འདྲ་བ་ནི་མིང་ཙམ་གྱིས་ཀྱང་གཞན་གྱི་གྲུབ་པར་མངོན་པར་འགྲོ་བ་མ་ལགས་༎
GK17jvrtmspu:220	 tīvratāpavidrutāyasacchaṭāsadṛkkaṭākṣasaṃyamakṣaṇā-dhīnaviśvasaṃcayaiś caturdigīśvaraiḥ prakṛtyudañcitātmabhiḥ /	T12D4305:385b-14	དྲག་པོར་གདུང་བས་རྣམ་པར་བཞུ་བའི་ལྕག་གི་ཟེར་དང་འདྲ་བའི་མིག་ཟུར་སྡོམ་པའི་སྐད་ཅིག་ལ་༎ སྣ་ཚོགས་ཡང་དག་འཕྲོ་བ་དབང་གྱུར་ཕྱོགས་བཞིའི་དབང་ཕྱུག་རང་བཞིན་གྱིས་མཐོར་སྐྱེས་པའི་བདག་ཉིད་ནི་༎ རྣམ་པར་འཕྲུལ་པའི་སྤྲོས་པ་རྒྱས་པ་སྤྲོ་བྱེད་མདའ་ལྔ་པ་ནི་འཇོམས་བྱེད་རྣམས་དང་མཛེས་མ་ཡི་༎
GK17jvrtmspu:221	 sphāravibhramaprapañcapañcapañcabāṇajiṣṇubhir daśātmanā sundarījanena cātanoṣi kām api prakāmavismayāṃ śriyam // JVms_110 //	T12D4305:385b-17	སྐྱེ་བོ་བཅུ་ཡི་བདག་ཉིད་ཀྱིས་ཀྱང་རབ་ཏུ་འདོད་བྱའི་ངོ་མཚར་དཔལ་ནི་ཅི་ཡང་རྒྱས་པར་བྱེད་༎ མ་རིག་མངོན་པར་བཅོམ་པ་ཁྱོད་ལ་མཆོད་པར་འདོད་པའི་རིག་འཛིན་བུ་མོ་དྲི་བཟང་གིས་བཀུག་༄༣༨༦ཨ་༌་༎ པའི་༏་། བུད་བའི་ཚོགས་རྣམས་དགའ་བས་སྒྲོགས་ཤིང་མཆོག་ཏུ་རོལ་པའི་མེ་ཏོག་ཕྲེང་བ་འཛིན་མ་མཛེས་མ་ཡི་༎
GK17jvrtmspu:222	 utkīrṇonnidrakundaprakaram iva dṛśāṃ cārubhaṅgais tribhāgaiḥ svedasrastāṅgarāgasnapitam iva muhuḥ kāntakānticchaṭābhiḥ /	T12D4305:386a-2	འོད་ཟེར་སྤྲོམ་རྣམས་ཀྱིས་ནམ་མཁའ་ཀུན་ཁྱབ་པ་ནི་མིག་གི་ཟུར་མིག་མཛེས་པ་བསྟེན་པ་ཡིས་༎ རབ་རྒྱས་ཀུནདའི་ཚོགས་གྱིས་རབ་དཀྲིགས་བཞིན་དང་རྡུལ་ཟགས་ཡན་ལག་བརླན་པས་ཡང་ཡང་བཀྲུས་པ་བཞིན་༎
GK17jvrtmspu:223	 vyāptaṃ vyoma tvadarcārucibhir abhihatāvidya vidyādharībhiḥ saurabhyākṛṣṭahṛṣṭakvaṇadalipaṭalollāsitasragdharābhiḥ // JVms_111 //	T12D4305:386a-4	དབང་པོ་བཅོམ་ལྡན་བླ་མར་གུས་པ་ཉིད་དག་ཚིག་གིས་རྟོགས་བྱ་མིན་པ་ཡོན་ཏན་རྒྱ་མཚོ་གང་ཞིག་། སྲིད་པའི་ལམ་དུ་འགྲོ་བའི་སྐྱེ་བོ་ཁྱོད་ཀྱི་མཚན་གྱི་རང་བཞིན་གླུ་དབྱངས་རྟག་ཏུ་ལེན་པ་འདིས་ནི་༎
GK17jvrtmspu:224	 ākṛtijanmavṛttavibhavakramātiśayasaṃpadaḥ sukham iyād īśa digantagītam amalaṃ yaśaś ca śaradindusundarataram /	T12D4305:386a-5	གཟུགས་དང་སྐྱེ་ཚུལ་དང་ནི་རྣམ་པར་འབྱོར་དང་རྣམ་གནོན་ཁྱད་འཕགས་ཕུན་སུམ་ཚོགས་མཐའ་༎ སྒྲོགས་པའི་གྲགས་པ་དྲི་མ་མེད་པ་སྟོན་ཀའི་ཟླ་ལྟར་མཆོག་ཏུ་རབ་མཛེས་ངེས་པར་བདེ་བླག་སྒྲུབ་བོ་༎
GK17jvrtmspu:226	 madhvāsārasnātodbhrāntaprabalamadamukkharamadhukaranikaraṃ prīter ekaṃ līlāvāsaṃ viditabalam api munihṛdayavikṛtaḥ /	T12D4305:386a-8	བློ་གྲོས་བཟང་པོས་བདུད་རྩིའི་རྒྱུན་གྱིས་བཀྲུས་པར་གྱུར་ཅིང་སྟེང་དུ་འཁོར་ལ་རབ་ཆེར་མྱོས་པ་གླུ་ལེན་པའི་༎ སྦྲང་རྩི་བྱེད་པའི་ཚོགས་ལྡན་དགའ་བའི་རོལ་པའི་གནས་གཅིག་ཐུབ་པའི་ཡིད་ནི་རྣམ་པར་འགྱུར་བར་བྱེད་པ་ཡང་༎
GK17jvrtmspu:227	 vāgīśāna tvayy ekāntaṃ vasuviṣayaviratisamupacitabaliḥ saṃbhogaśrīmattākrīḍaṃ varada divi niyatam anubhavati // JVms_113 //	T12D4305:386a-10	སྟོབས་ཡོད་གྱུར་པའི་ལོངས་སྤྱོད་དཔལ་ལྡན་ཉིད་ཀྱིས་རྩེན་པ་མཐོ་རིས་རྣམས་སུ་ངེས་པར་ཉམས་སུ་མྱོང་བར་བྱེད་༎ སྟོབས་རྣམས་ཀྱི་གཏེར་ཁྱོད་ཉིད་གཅིག་པུ་སྐྱབས་བྱས་མི་ནི་ཆང་གི་ལྕི་བའི་འགྲམ་པས་བསྒྲགས་པ་རབ་མཐོ་བའི་༎
GK17jvrtmspu:228	 madagurugaṇḍagarjitajitonnatāmbudagajendravṛndamalinaṃ niśitasamastaśastrakiraṇaprabhāmbarapinaddhapattinivaham /  pravararathādhirūḍhasubhaṭaṃ balaṃ balanidhe tvadekaśaraṇaṃ śrayati naraṃ manoharayatipraveśavaśagottamāśvalalitam // JVms_114 //	T12D4305:386a-12	སྤྲིན་དག་ཕམ་བྱེད་གླང་ཆེན་དབང་པོའི་ཚོགས་ཀྱི་དྲི་མ་ཅན་གྱུར་རྣོ་བྱས་མཐའ་དག་མཚོན་ཆའི་འོད་ཟེར་དག་།འཕྲོ་པའི་གོས་དག་བཅིངས་པའི་རྐང་ཐང་ཚོགས་ཅན་རབ་མཆོག་ཤིང་རྟ་བཞོན་པའི་དམག་མི་བཟང་ལྡན་ཡིག་འཕྲོག་པའི་༎ ཇལ་སོ་དང་ནི་རབ་ཏུ་འཇུག་དང་དབང་དུ་འགྲོ་བའི་རྟ་མཆོག་རྣམས་ཀྱི་རོལ་པ་ཅན་དཔུང་རྟེན་པར་བྱེད་༎ མཁས་པ་རྣམས་ཀྱི་ས་ལ་བཞུགས་པའི་དབང་པོ་དགའ་བའི་གནས་གྱུར་རབ་མཆོག་རྒྱ་མཚོ་རབ་སྦྱིན་བསྟེན་པར་མཛད་པ་༎
GK17jvrtmspu:231	 yauvanalīlāsacivasamudayatpañcamakasvarayatiramaṇīyā syād iha tanvī himakaravadanā tadvaśagā saha narapatilakṣmyā // JVms_115 //	T12D4305:386a-16	ན་ཚོད་ཀྱིས་རོལ་བློན་པོ་ཅན་གྱི་ཚོགས་ནི་ལྔ་པའི་དབྱངས་དག་སྒྲུབ་པར་བྱེད་པའི་ངལ་སོས་དགའ་བར་བྱ་ལ་༎
GK17jvrtmspu:270	 sarvātiśayasya dhāma dhāmnaḥ sarvāṅgīṇasulakṣyalakṣaṇaśrīḥ /	T12D4305:388a-9	ཀུན་ལས་ཁྱད་པར་འཕགས་པའི་གཟི་བརྗིད་ཀྱི་གནས་༎ ཡན་ལག་ཀུན་ཁྱབ་མཚོན་སླ་མཚན་གྱི་དཔལ་ལྡན་ཞིང་༎ བཟང་པོ་རྣམ་པར་གསལ་བ་ཁྱོད་སྐུ་ཀུན་གྱིས་༎
GK17jvrtmspu:272	 paritaḥ sphuradbhir abhirāmair aṃśumayaiḥ parārthaparamārthaiḥ /	T12D4305:388a-13	གཞན་དོན་མཆོག་ཏུ་དོན་གཉེར་རྣམས་ཀྱིས་ཁྱོད་སྐུ་ཀུན་ནས་འཕྲོ་ཞིང་མངོན་པར་དགའ་འོས་འོད་ཟེར་གྱི་༎
GK17jvrtmspu:273	 pavipadmakhaḍgamaṇicakraiḥ ketumatī vibhāti tava mūrtiḥ // JVms_134 //	T12D4305:388a-14	རང་བཞིན་རྡོ་རྗེ་པདམ་རལ་གྲི་ནོར་བུ་༎ འཁོར་ལོ་རྣམས་ཀྱི་ཏོག་དང་ལྡན་པར་རྣམ་པར་སྣང་༎
GK17jvrtmspu:275	 seyam etadākṛticchalād ato 'va-yavadhvaner matupstriyā samābhidhānā // JVms_135 //	T12D4305:388a-17	དེ་འདི་ཁྱོད་ཀྱི་དབྱིབས་ཀྱིས་དོར་ཏེ་དེ་ཕྱིར་ཆ་ཤས་༎ སྒྲ་དང་ལྡན་པའི་རྐྱེན་དང་བུད་མེད་རྟགས་ཀྱིས་བརྗོད་པའོ་༎
GK17jvrtmspu:276	 udayadaruṇakiraṇanikaraparikara-kanakamayavimalahimakarajayanī /	T12D4305:388a-19	འཆར་བཞིན་པ་ཡི་སྐྱ་རེངས་རྣམས་ཀྱི་འོད་ཟེར་ཚོགས་ཀྱིས་ཡོངས་སུ་བསྐོར་བའི་༎ གསེར་གྱི་རང་བཞིན་དྲི་མ་དང་བྲལ་ཁ་བའི་འོད་ལས་ངེས་རྒྱལ་བ་༎
GK17jvrtmspu:278	 tribhuvanaduradhigamacaraṇaparicaraṇaguruvibhavabhagavadasitasugata-pratikṛtisacivavimalamaṇinicayakhacitasuparighaṭanaguṇavasatiḥ /	T12D4305:388a-21	འགྲོ་བ་མ་ལུས་མངོན་པར་དགའ་བར་བྱེད་ལ་མཁས་ཤིང་ཤིན་ཏུ་མཛེས་པ་༎ ཁྱོད་ཀྱི་སྐུ་ལུས་འདི་ཡིས་རྒྱལ་བར་གྱུར་ཅིག་ཤིན་ཏུ་བྱུང་བ་ཀྱེ་༎ སྲིད་པ་གསུམ་གྱིས་རྟོགས་པར་དཀའ་བའང་ཞབས་ལ་ཡོངས་སུ་རྒྱུ་བ་ཅན་གྱི་རྣལ་འབྱོར་ལྕི་བ་བཅོམ་ལྡན་བདེ་བར་གཤེགས་པ་དཀར་པོ་མ་ཡིན་པའི་༎ གཟུགས་བརྙན་དང་མཚུངས་དྲི་མ་རྣམ་པར་བྲལ་བའི་ནོར་བུ་ངེས་པར་བསགས་པས་སྤྲས་ཕྱིར་ལེགས་པར་ཡོངས་སུ་འབྱོར་བའི་ཡོན་ཏན་རྣམས་ཀྱི་གནས་༎
GK17jvrtmspu:279	 jinanayagadanaravalayalavasamanukṛtirasikanibhasurabhisurasumanaḥ-parimalamiladalikulakaṇitanidhir adhigamajalada jayati tava śikhā // JVms_137	T12D4305:388a-25	རང་གི་ཚུལ་ལུགས་རྗོད་པར་བྱེད་པའི་སྒྲ་ནི་ཞུམ་པ་བརྗོད་པ་ཡང་དག་རྗེས་སུ་བྱེད་ལ་རོ་ཅན་ལྟ་བུའི་ལྷ་ཡི་མེ་ཏོག་དྲི་བཟང་པོ་༎ ཡོངས་སུ་བྱུགས་པའི་དྲི་བཟང་གིས་འདུས་བུང་བའི་ཚོགས་ཀྱི་འཕུངས་གཏེར་ཁྱོད་ཀྱི་གཙུག་གི་ཕུད་ཀྱིས་རྒྱལ་བར་གྱུར་ཅིག་རྟོགས་པའི་ཆུ་གཏེར་གྱི་༎
GK17jvrtmspu:280	 samudayadiśi samupanataruciṣu vividhasamudayakaraṇam abhidadhatī praśamasukharasarasikamatiṣu nirupamaśamasukhapathakathanapṛthuniratiḥ /	T12D4305:388a-27	ཡང་དག་དར་བའི་ཕྱོགས་ལ་འདོད་པ་ཉེ་བར་བབ་བ་རྣམས་ལ་ཡང་དག་དར་བར་བྱེད་པ་རྣམ་པ་སྣ་ཚོགས་མངོན་པར་རྗོད་བྱེད་ཅིང་༎ རབ་ཏུ་ཞི་བའི་བདེ་བའི་རོལ་རོ་མྱོང་བློ་ཅན་རྣམ་ལ་དཔེ་ཟླ་མེད་པའི་ཞི་བའི་བདེ་བའི་ལམ་རྗོད་བྱེད་ལ་ལྟུར་ལེན་ཆེན་པོ་ཅན་༎
GK17jvrtmspu:281	 aparimitasukṛtaphalam adhipa tava jayati sakalajinanayanayanagīr ṛjumatiṣu niyatam ṛjur amṛtakuṭa kuṭilamatiṣu niratiśayakuṭilapadā // JVms_138	T12D4305:388b-0	དཔག་ཏུ་མེད་པའི་ལེགས་པར་བྱས་པའི་འབྲས་བུ་བློ་ཅན་རྣམས་ལ་ངེས་པར་དྲང་ཞིང་གྱ་གྱུའི་བློན་ཅན་རྣམས་ལ་ཕུལ་༄༣༨༨བ་དུ་ནི་༎ དབྱུང་དུ་མེད་པའི་འཁྱོག་པའི་ཚིག་ཅན་ཁྱོད་ཀྱི་གསུང་གིས་རྒྱལ་བར་གྱུར་ཅིག་ལྷག་པའི་བདག་པོ་རྒྱལ་བའི་ཚུལ་གྱི་འདྲེན་བྱེད་བདུད་རྩིའི་ཁང་བ་ཀྱེ་༎ གང་ཞིག་ཁྱོད་ལ་བསྟོད་ཅིང་ཁྱོད་ཀྱི་ཡོན་ཏན་རྣམས་༎
GK17jvrtmspu:283	 nūṇaṃ sa gaṇḍūṣajalopayogān mayā nipīto 'mbudhir ity aveti // JVms_139 //	T12D4305:388b-4	དེ་ནི་ངེས་པར་འཁུར་བ་གང་བའི་ཆུ་ལྡན་བས་༎ བདག་གི་ཆུ་གཏེར་ངེས་པར་འཐུངས་སོ་ཞེས་པ་ཉིད་༎
GK17jvrtmspu:284	 api tv aśeṣasmaravairiṇām apy ākhyeyatākhyātim anāśriteṣu /  guṇeṣu te nātha vṛthābhimānasya-ākhyānikāsau viparītapūrvā // JVms_140 //  // iti duṣkaraprabhedavṛttamālāvivṛtan ardhasamavṛttāni //	T12D4305:388b-6	འོ་ན་ཀྱང་དྲན་པའི་དགྲ་བོ་མ་ལུས་རྣམས་ཀྱིས་ཀྱང་༎ བརྗོད་བྱ་ཉིད་ནི་བརྗོད་མི་སྤྱོད་པ་མགོན་ཁྱོད་ཀྱི་༎ ཡོན་ཏན་རྣམས་ལ་དོན་མེད་མངོན་པའི་ང་རྒྱལ་གྱིས་༎ བརྗོད་པ་འདི་ནི་ཕྱིན་ཅི་ལོག་པ་སྔ་མ་ཅན་༎ ཞེས་པ་འཇུག་ཚུལ་ཕྲེང་བ་ཕྱེད་མཉམ་པའི་བྲིཏཏ་རྣམས་སོ་༎
GK17jvrtmspu:287	 aṣṭābhir akṣaraiḥ pādo 'soḍhas tadgāḍhamajjanād anuvṛddhaiḥ /  guṇasāgara sāgarair apūritāṅgurīgarto viṣamaṃ daśāntare dayā padacaturūrdhvaṃ nayati bhāvam // JVms_141 //	T12D4305:388b-11	ཡོན་ཏན་རྒྱ་མཚོ་སྐབས་གཞན་རྣམས་སུ་༎ རྒྱ་མཚོ་མ་བསྐམས་བརྒྱད་པོ་ཞབས་ཀྱིས་ཏེ་པོར་བཙིར་ལས་༎ འཕེལ་པ་རྣམས་ཀྱིས་སོར་མོའི་ཁུང་བུ་གང་བ་མིན་ཞིང་བཟོད་བྱ་མིན་པ་༎ ཞབས་ཅན་མི་མཉམ་པ་ནི་རྐང་པ་བཞི་པོ་གོང་མ་ཅན་གྱི་ཐུགས་རྗེའི་དགོངས་པ་ཐོབ་བྱེད་༎
GK17jvrtmspu:289	 iti nigaditajātau kṛtaviṣamacaraṇaracanāyām /	T12D4305:388b-15	ཅེས་པས་ངེས་པར་བསྒྲགས་པའི་རང་བཞིན་༎ མི་ཟད་ཞབས་ཀྱི་བཀོད་པ་བྱ་ཞིང་ཡང་བ་དང་ནི་༎
GK17jvrtmspu:290	 laghuguruniyatibhṛti bhayam ayati ko na bhavasi na yadi niyatam abhividhivacanam anu pīḍaḥ // JVms_142 //	T12D4305:388b-17	ལྕི་བའི་ངེས་པ་འཛིན་ལ་གལ་ཏེ་ཁྱོད་ཀྱིས་ངེས་པར་མངོན་པར་སྨྲེ་སྔགས་༎ ཚིག་སྒྲུབ་པ་ལ་རྗེས་སུ་གདུང་བར་མི་འགྱུར་བ་ནི་འཇིགས་པར་འགྱུར་བ་མིན་པ་སུ་ཡིན་༎ མ་རུངས་སྐྱེ་བོ་འདུལ་བར་བྱེད་ཅིང་༎
GK17jvrtmspu:291	 suciranihitahitamatikandāṅ-kura iva tava bhāti /  viṣamajanadamanaghaṭitavikaṭamūrtes tripuraharamukuṭamaṇisadṛśadaśanakalikeyam // JVms_143 //  prasaradurudahanaghanaghora-cchaṭam iva gaganatalam anavadhi dadhānā /	T12D4305:388b-20	རྣམ་པར་གཙིགས་པའི་སྐུ་ལུས་སྟོན་པར་མཛད་པ་ཁྱོད་ཀྱིས་༎ མེ་ཏོག་ཁ་འབུས་འདི་ནི་གྲོང་གསུམ་འཕྲོག་པའི་ཅོད་པན་ནོར་བུ་འདྲ་དང་༎ ཤིན་ཏུ་ཡུན་རིངས་པན་པའི་བློ་གྲོས་ངེས་པར་མཛད་པའི་སྡོང་བུའི་མྱུ་གུ་བཞིན་དུ་སྣང་ངོ་༎
GK17jvrtmspu:294	 prasabham abhimukhaṃ te praśamayati śamanam api nayanavalanalavalīlā // JVms_144 //	T12D4305:388b-22	ཁྱོད་ཀྱི་སྤྱན་གྱིས་ཅུང་ཟད་གཏད་པའི་རོལ་བ་རབ་ཏུ་༎ སྟོབས་ལྡན་མངོན་པར་མངོན་པར་ཕྱོགས་པས་མེ་ཆེན་སྟུག་པོ་འཇིགས་སུ་རུང་བའི་༎
GK17jvrtmspu:295	 mṛdujanam anu punar iyam eva praśamitasakalakaṭukaluṣaviṣarāśiḥ /	T12D4305:388b-24	དྲ་བ་རབ་ཏུ་རྒྱས་པའི་ནམ་མཁའི་མཐིལ་དུ་བར་མཚམས་མེད་པ་འཛིན་པར་བྱེད་ཅིང་གཤིན་རྗེ་༎ ཡང་ནི་རབ་ཏུ་ཞི་བར་མཛད་དོ་༎ འདི་ནི་ཁོ་ན་སྡིག་པ་དྲག་པོ་དུག་གི་ཕུང་པོ་༎
GK17jvrtmspu:296	 pratimuhur abhinavam atulasukhanidhim upanayantī niyatam amṛtadhāra // JVms_145 //  padacaturūrdhvaprabhedāḥ // //	T12D4305:388b-27	མཐའ་དག་རབ་ཏུ་ཞི་བྱས་སླར་ཡང་སྐྱེ་བོ་འཇམ་པོའི་རྗེས་སུ་ཡང་དང་༎ ཡང་དུ་མངོན་པར་གསར་བའི་བདེ་བ་མཉམ་པ་མེད་པའི་གཏེར་དག་ཀུན་དུ་འདྲེན་པར་བྱེད་ཅིང་༎ ངེས་པར་གྱུར་པའི་བདུད་རྩིའི་རྒྱུན་ལགས་༎
GK17jvrtmspu:298	 taḍitojjvalaṃ jaladarāśim aniśam udabhārabandhuram /  ghoraghanarasitam īśa tanuḥ kṛpayā kuto 'pi jayatīyam udgatā // JVms_146 //	T12D4305:388b-29	དབང་པོ་སྐུ་ལུས་ཆུ་གཏེར་ཕུང་པོ་གློག་གིས་༎ མཆོག་ཏུ་འབར་ཞིང་ཆུ་ཡི་ཁུར་གྱིས་ལྗིད་ལ་༎ འཇིགས་རུང་འབྲུག་སྒྲ་ཆེ་ལྡན་ཐུགས་རྗེ་ལྕི་ཡང་གིས་༎ འགྲོ་བ་རྒྱུན་དུ་འཕགས་པ་འདི་ཡིས་རྒྱལ་གྱུར་ཅིག་།འདི་ཉིད་ཕྱིར་ན་ཤིན་ཏུ་བྱ་བ་དཀའ་བ་ཡི་༎
GK17jvrtmspu:3	 pratiniyatākṛtirūḍhaṃ varamunibhir yatra nāma saṃgītam /	T12D4305:379b-9	གང་དུ་རབ་ཏུ་ངེས་པའི་དབྱིབས་གྲགས་ཤིང་༎ ཐུབ་མཆོག་རྣམས་ཀྱི་མཚན་ནི་ཡང་དག་བརྗོད་༎
GK17jvrtmspu:301	 hlādayaty akhilalokam idaṃ paṭukīrtisaurabhakam adbhutaṃ tava // JVms_147 //	T12D4305:388b-34	ཁྱོད་ཀྱིས་གསལ་བར་གྲགས་པའི་དྲི་བཟང་ཉིད་ཀྱིས་༎ འཇིག་རྟེན་མ་ལུས་ཚིམ་པར་མཛད་༎
GK17jvrtmspu:302	 bhṛkuṭīkaṭākṣadaśaneṣu kim api vikṛtāni bibhrataḥ /	T12D4305:389a-2	ཁྲོ་གཉེར་གཟིགས་སྟངས་ཅན་གྱི་ཚེམས་རྣམས་ལ་ནི་༎
GK17jvrtmspu:303	 damayati tava bhuvanāni vapur lalitaṃ ca kiṃ tu vikaṭaṃ yad īdṛśam // JVms_148 //	T12D4305:389a-3	རྣམ་པར་འགྱུར་རྣམས་ཅི་ཡང་རྣམ་པར་འཛིན་པ་༎ ཁྱོད་ཀྱི་སྐུ་ལུས་རྒྱལ་བར་གྱུར་ཅིང་འོན་ཀྱང་གང་ཞིག་། མི་བཟད་འདི་འདྲ་བ་ཡིས་འཇིག་རྟེན་པ་རྣམས་འདུལ་བར་མཛད་ལ་༎
GK17jvrtmspu:304	 // udgatābhedāḥ // //  prāgbhārātiśaye 'pi tādṛśe 'dbhutabhīme bhuvanāhitahataye samaṃ samantāt /	T12D4305:389a-5	རི་ཡི་བྱ་སྐྱིབས་འཇིགས་པ་རྨད་བྱུང་ཕུལ་བྱུང་དེ་འདྲ་བ་ཡང་༎ འགྲོ་ལ་མི་ཕན་གཞོམ་པའི་ཆེད་དུ་ཀུན་དུ་མཉམ་དུ་ནི་༎
GK17jvrtmspu:306	 marud anatiśayarayaḥ pracupitam api tava na sameti salīlam // JVms_149 //	T12D4305:389a-7	ཁྱོད་ཀྱིས་དལ་བུར་གཤེགས་པ་རོལ་པ་དང་༎ བཅས་ལའང་ཕུལ་དུ་དབྱུང་དུ་མེད་པའི་མགྱོགས་ལྡན་རླུང་གི་རྗེས་འགྲོ་མིན་༎
GK17jvrtmspu:307	 kiṃ bhūyo bhagavan bhavantam aśrayam āptaḥ sthitabhāram atulam ārṣabhaṃ dadhānam /  tac chuddhavirāḍviśeṣaṇam hy aparaviṣamaśirasi padaṃ vinidhatte // JVms_150 //  ārādhyeti bhavantam āśrayaikasamṛddhyā kuśalaṃ yad amalam asti vardhamānam /	T12D4305:389a-8	གཞན་ཡང་བཅོམ་ལྡན་འདས་ཀྱི་ཁྱུ་མཆོག་རླབས་པོ་ཆེའི་༎
GK17jvrtmspu:4	 chandaḥ padaṃ ca paramaṃ sphurati yathāvividhavinyāsaiḥ // JVms_2 //	T12D4305:379b-11	ཇི་ལྟར་རྣམ་མང་རྣམ་པར་བཀོད་པ་ཡིས་༎ སྡེབ་སྦྱོར་ཚིག་ཀྱང་མཆོག་ཏུ་སྤྲོས་པར་འགྱུར་༎
GK17jvrtmspu:5	 pratirūpadarśanād api śakyāḥ sakalakrameṇa gurulaghavaḥ /	T12D4305:379b-13	སོ་སོའི་གཟུགས་ནི་མཐོང་བ་དག་ལས་ཀྱང་༎ མཐའ་དག་རིམ་ལས་ལྕི་དང་ཡང་བ་རྣམས་། བློ་ལྡན་རྣམས་ཀྱིས་རྣམ་པར་བགྲང་བར་ནུས་༎
GK17jvrtmspu:52	 kalayitum iha kaḥ śaktas tava khalu caritānīśa /  satamasi samaye toye bhujagaśiśusṛtānīva // JVms_26 //  kintūdasyati dhairyadhvasrī tvatkīrtiśrutijanmānandaḥ /  svaprauḍhipratipattinyastāṃ lokasyānanamudrām īśa // JVms_27 //  bhāti varṣma buddhātmajapaṅktau yadvad ambujanmasv aravindam // JVms_28 //	T12D4305:380b-6	བླུན་པོ་རྣམ་པར་འཇོམས་ནུས་འཇིག་རྟེན་གསུམ་གྱི་༎
GK17jvrtmspu:58	 tvām udgītakulodayaśailaṃ prajñālokam upāyarathastham /  vande jāḍyavikhaṇḍanaśauṇḍaṃ trailokīnalinīsavitāram // JVms_29 //	T12D4305:380b-7	པདམོ་ཅན་གྱི་ཉི་མ་ཁྱོད་ལ་འདུད་དོ་༎
GK17jvrtmspu:6	 vigaṇayituṃ dhīmadbhiḥ kim aparam atrānuyogena // JVms_3 //	T12D4305:379b-15	འདིར་ནི་གཞན་དག་རྗེས་སུ་སྦྱར་བས་ཅི་༎
GK17jvrtmspu:60	 buddhasutānām abhyudayorvī bhāti bhṛśaṃ bhūtyā tava nātha /	T12D4305:380b-8	སངས་རྒྱས་སྲས་རྣམས་མངོན་པར་འབྱུང་བའི་ས་ནི་༎ མགོན་པོ་ཁྱོད་ཀྱི་འབྱོར་བ་མཆོག་ཏུ་མཛེས་ཏེ་༎
GK17jvrtmspu:61	 śailaviśeṣasyeva śikhābhū rukmavatī ratnāṅkurakāntyā // JVms_30 //	T12D4305:380b-10	རི་ཡི་ཁྱད་པར་དག་གེ་རྩེ་མོའི་ས་ནི་༎ གསེར་ལྡན་རིན་ཆེན་མྱུ་གུས་མཛེས་པ་བཞིན་ནོ་༎
GK17jvrtmspu:62	 niḥśeṣas tava vijayadhvānaṃ tanvan bhrāmyati bhuvanoddyota /	T12D4305:380b-12	མ་ལུས་མཁས་པའི་ཚིག་ནི་ཀུན་དགའ་ལྡན་པས་༎ མགོན་པོ་འཇིག་རྟེན་གསལ་བར་མཛོད་པ་ཁྱོད་ཀྱི་༎ རྣམ་རྒྱལ་སྒྲ་ནི་རྒྱས་པར་བྱེད་ཅིང་རྒྱུ་སྟེ་༎
GK17jvrtmspu:63	 sānandaḥ kṛtinivahaḥ svāmin viṣvag ghoṣaṇapaṇavo yadvat // JVms_31 //	T12D4305:380b-15	ཇི་ལྟར་ཀུན་དུ་སྒྲོགས་པར་བྱེད་མེད་པ་བཞིན་༎ རྒོལ་བའི་ཚོགས་ཀྱི་རབ་མཆོག་མགོ་བོའི་ཆུ་སྐྱེས་༎
GK17jvrtmspu:64	 vādivrātapravaraśiro'bja śrīdhāmnas te guṇamadhuyogāt /	T12D4305:380b-17	བློ་ལྡན་དཔལ་གྱི་གནས་གྱུར་ཁྱོད་གསུང་འཇིག་རྟེན་༎ ཡོན་ཏན་སྦྲང་ཆང་སྦྱོར་བས་མྱོས་པས་མཁས་པ་༎
GK17jvrtmspu:65	 dhīman dhīrān api mādayantī trailokī vāg vilasati mattā // JVms_32 //	T12D4305:380b-19	རྣམས་ཀྱང་མྱོས་པར་བྱེད་ཅིང་རྣམ་པར་རོལ་ལོ་༎ རྒྱལ་བ་ཀུན་གྱི་འཁོར་ལོས་སྒྱུར་བ་རྣམས་ཀྱི་༎ རིགས་ཀྱི་རྒྱན་གྱུར་ཁྱོད་ལ་གསལ་བ་ཉིད་དུ་༎
GK17jvrtmspu:67	 mlāyatīva sā kumāratākhyā yā mayūrasāriṇīṣyate tu // JVms_33 //	T12D4305:380b-22	གཞོན་ནུ་ཉིད་ཅེས་བྱ་བར་འདོད་པ་དེ་ནི་༎ རྨ་བྱའི་འགྲོས་ལ་དམན་པ་ཉིད་གྱུར་བཞིན་ནོ་༎
GK17jvrtmspu:68	 nānāratnamarīcimālinī pronmīlannijakāntisaṃpadā /  pratyaṅgaṃ tava bhūṣaṇāvalī nītā śuddhavirāṭ parābhavam // JVms_34 //	T12D4305:380b-24	དག་ཅིང་རྣམ་མཛེས་ཡན་ལག་སོ་སོ་དག་ཏུ་༎ རབ་གསལ་རང་གི་མཛེས་པ་ཕུན་སུམ་ཚོགས་པ་༎ སྣ་ཚོགས་རྣམ་པར་འཕྲོ་བའི་འོད་ཟེར་ཕྲེང་ལྡན་༎ ཁྱོད་ཀྱིས་རྒྱན་ཕྲེང་ཟིལ་གྱིས་མནན་པར་གྱུར་ཏོ་༎
GK17jvrtmspu:7	 prabhavatu vibhramahataye vicintyamānaṃ tad ādarād bhavatām /  sukṛtimukhābhijanānāṃ vācāṃ nijam ekam ābharaṇam // JVms_4 //	T12D4305:379b-16	ལེགས་བྱས་ཞལ་ལས་མངོན་པར་འཁྲུངས་གྱུར་པ་༎
GK17jvrtmspu:70	 pātu jagat tava tattvanayā-khyānavidhau karavalgitakam /  vādipate vyatighaṭṭanato valguninādacaladvalayam // JVms_35 //	T12D4305:380b-28	སྨྲ་བ་པོ་བདག་དེ་ཉིད་ཚུལ་འཆད་སྒྲུབ་ལ་༎ ཁྱོད་ཀྱི་ལག་ག-ཡོ་ཕན་ཚུན་ཕྲད་པ་དག་ལས་༎ སྒྲ་སྙན་སྒྲོགས་པར་བྱེད་ཅིང་གདུབ་བུ་དག་ནི་༎
GK17jvrtmspu:72	 rūpaṃ te guṇagaṇam atha kīrtiṃ saṃvīkṣyākhilam idam atiśāyi /	T12D4305:380b-31	ག-ཡོ་བ་དག་གིས་འགྲོ་རྣམས་བསྲུང་བར་གྱུར་ཅིག་། ཁྱོད་ཀྱི་གཟུགས་དང་ཡོན་ཏན་ཚོགས་དང་གྲགས་པ་དག་། ཕུལ་བྱུང་ལྡན་འདི་མ་ལུས་ཡང་དག་མཐོང་གྱུར་ནས་༎
GK17jvrtmspu:73	 bibhrāṇaṃ nijaviṣayaviśrāmaṃ mandaṃ triṣṭubhi jagad upajātam // JVms_36 //	T12D4305:380b-32	རང་གི་ཡུལ་ལ་དགའ་བྲལ་རྣམ་པར་འཛིན་བྱེད་ཅིང་༎ གསུམ་བསྔགས་དག་ལ་འགྲོ་བ་དམན་པར་ཉེ་བར་གྱུར་༎
GK17jvrtmspu:74	 tanur atanudayādravopama-sphuradanupamakāntisaṃtatiḥ /	T12D4305:380b-34	གཙོ་བོ་ཁྱོད་ཀྱི་སྐུ་ནི་ཀུན་ནས་བཟང་ལྡན་པ་༎ མི་ཆུང་རྩེ་བ་དག་གི་ཁུ་བ་ལྟ་བུ་ཡི་༎
GK17jvrtmspu:75	 janayati bhavato na kasya vā mudam adhipa samantabhadrikā // JVms_37 //	T12D4305:380b-36	མཛེས་པའི་རྒྱུན་ནི་དཔེ་མེད་རབ་ཏུ་འཕྲོ་བ་དག་། སུ་ཡི་དགའ་བ་དག་ནི་སྐྱེད་པར་བྱེད་མ་ཡིན་༎
GK17jvrtmspu:76	 śaradamṛtakarakaraśreṇī-samahimagatamalagaurīyam /	T12D4305:381a-0	སྟོན་ཀའི་བདུད་རྩིའི་ཟེར་གྱི་འོད་ཟེར་འཕྲོ་བ་དང་༎ ཁ་བ་དང་མཚུངས་དྲི་མ་༄༣༨༡ཨ་༌་༎ དང་བྲལ་དཀར་བ་ཡི་༎
GK17jvrtmspu:77	 guṇasamuditir iva muktālī vilasati hṛdi bhavato vṛttā // JVms_38 //  gīyamānasumanaḥsumanasvaj-jātikīrtivijayeva taveyam /	T12D4305:381a-2	མུ་ཏིག་ཕྲེང་བ་ཟླུམ་པོ་འདི་ནི་ཁྱོད་ཐུགས་ལ་༎ ཡོན་ཏན་ཚོགས་པ་བཞིན་དུ་ཁྱོད་ལ་རྣམ་པར་མཛེས་༎
GK17jvrtmspu:79	 bhāti dūratatasaurabhalobha-svāgatālipaṭalakvaṇitena // JVms_39 //	T12D4305:381a-4	རིང་དུ་རྒྱས་པའི་དྲི་བཟང་དག་ལ་ཆགས་གྱུར་ཅིང་༎ ལེགས་པར་འོངས་པ་བུང་བའི་ཚོགས་ནི་སྒྲོགས་བྱེད་པས་༎
GK17jvrtmspu:80	 sphārāmodā madhunidhir adhikaṃ cūrṇaṃ cātuḥsamaṃ iva dadhatī /  nīlābjaśrīr dalasukhaśayanā-saṃparyāptabhramaravilasitā // JVms_40 //  rūparasāyanabhāvanayā te vāsava eva paraṃ bahumānyaḥ /	T12D4305:381a-6	ཡིད་བཟང་དག་ལས་ཡིད་བཟང་ལྡན་པ་ཛའ་ཏི་ཡི་༎ གྲགས་པ་རྣམ་པར་རྒྱལ་བ་བཞིན་དུ་སྒྲོགས་བྱེད་ཅིང་༎ དྲི་བཟང་རབ་གསལ་སྦྲང་རྩིའི་གཏེར་ནི་ལྷག་གྱུར་པ་༎ གཞི་མཉམ་དག་གི་ཕྱེ་མ་འཛིན་པ་བཞིན་དུ་ནི་༎
