src_segmentnr	src_original	tgt_segmentnr	tgt_original
GK19kmeghdpu:100	 tasyāḥ pātuṃ suragaja iva vyomni paścārdhalambī tvaṃ ced acchasphaṭikaviśadaṃ tarkayes tiryag ambhaḥ /  saṃsarpantyā sapadi bhavataḥ srotasi cchāyayā sā syād asthānopagatayamunāsaṃgam evābhirāmā // KMgD_51 //	T12D4302:346a-1	དེ་ཡི་ཆུ་འཐུངས་བསམས་ནས་ལུས་ཕྱེད་ལྔ་མ་མཁར་ལས་འཕྱང་བ་ནི་༎ ལྷ་ཡི་གླང་པོ་བཞིན་ཏེ་ཆུ་དྲེའི་ཞིང་ནི་དྲི་མེད་དཀར་བའི་ཤེལ་བཞིན་སྣང་བ་ཉིད་༎ ཆུ་བོ་དེ་ལ་ཁྱོད་ཀྱི་གླག་མ་བསམ་པས་འཕྲལ་ལ་ཡང་དག་འབྱུང་འགྱུར་མཛེས་པ་ནི་༎ ཡ་མུ་ན་ཡི་ཆུ་དང་གངགའ་འགྲོགས་བའི་མཛེས་པ་ལས་འོངས་གྱུར་ལ་གནས་མ་ཡིན་༎
GK19kmeghdpu:102	 āsīnānāṃ surabhitaśilaṃ nābhigandhair mṛgāṇāṃ tasyā eva prabhavam acalaṃ prāpya gauraṃ tuṣāraiḥ /  vakṣyasy adhvaśramavinayane tasya śṛṅge niṣaṇṇaḥ śobhāṃ śubhratrinayanavṛṣotkhātapaṅkopameyām // KMgD_52 //	T12D4302:346a-5	རྡོ་ལེབ་སྟེང་དུ་རི་དགས་གནས་པས་རི་དགས་ལྟེ་བའི་དྲི་བཟང་འཛིན་པའི་རྡོ་ལྡན་ཞིང་༎ གངགའ་ཉིད་ཀྱི་ཡབ་གྱུར་ཁ་བར་དཀར་བའི་ག-ཡོ་མེད་གངས་ལྡན་དེ་ཉིད་ཐོབ་བྱས་ནས་༎ ལམ་གྱིས་ངལ་བ་རྣམ་པར་འདུལ་བའི་ཆེད་དུ་དེ་ཡི་རྩེ་ལ་སླེབས་ནས་འདུག་པ་ཡི་༎ མཛེས་པ་མིག་གསུམ་པ་ཡི་བཞོན་བ་དཀར་བའི་ཁྱུ་མཆོག་རབ༹་ཡིས་འདམ་ནི་གླངས་བ་བཞིན་༎
GK19kmeghdpu:104	 taṃ ced vāyau sarati saralaskandhasaṃghaṭṭajanmā bādhetolkākṣapitacamarībālabhāro davāgniḥ /	T12D4302:346a-9	དེ་ལ་གལ་ཏེ་རླུང་གིས་རབ་བསྐྱོད་ཐང་ཤིང་ལག་པ་ཀུན་དུ་འཐབས་པ་ལས་བྱུང་བའི་༎
GK19kmeghdpu:105	 arhasy enaṃ śamayitum alaṃ vāridhārāsahasrair āpannārtipraśamanaphalāḥ saṃpado hy uttamānām // KMgD_53 //	T12D4302:346a-10	མེ་ཡི་དུག་དང་མེ་སྟག་དག་གིས་འབྲོང་གི་དགའ་མའི་སྤུ་ཚོགས་མང་པོ་སྲེག་བྱེད་ན་༎ ཁྱོད་ཀྱིས་དེ་རྣམས་ཞི་བའི་ཆེད་དུ་ཆུ་འཛིན་སྟོང་ཕྲག་མང་པོ་ཆར་ནི་བྱ་བར་འོས་༎ གང་ཕྱིར་ཆེན་པོ་རྣམས་ཀྱི་ཕུན་ཚོགས་འབྲས་བུ་མང་པོའི་སྡུག་བསྔལ་ཞི་བར་བྱེད་པ་ཉིད་༎
GK19kmeghdpu:106	 ye tvāṃ muktadhvanim asahanāḥ svāṅgabhaṅgāya tasmin darpotsekād upari śarabhā laṅghayiṣyanty alaṅghyam /	T12D4302:346a-13	དེར་ནི་ཁྱོད་ཀྱིས་སྒྲ་ཆེན་བསྒྲགས་ལ་མ་བཟོད་ཆེ་བའི་དྲེགས་པ་ཀུན་དུ་ལྡན་པའི་རྐང་བརྒྱད་པ་༎ ཁྱོད་ཀྱི་སྟེང་དུ་མཆོད་བར་བྱའོ་སྙམ་ནས་མ་མཆོངས་རང་གི་ཡན་ལག་ཀུན་དུ་རྨས་༎
GK19kmeghdpu:107	 tān kurvīthās tumulakarakāvṛṣṭihāsāvakīrṇān ke vā na syuḥ paribhavapadaṃ niṣphalārambhayatnāḥ // KMgD_54 //	T12D4302:346a-15	དེ་རྣམས་དག་ལ་རབ་ཏུ་བཞད་ལྡན་ཐོག་སེར་ཆར་པ་དྲག་ཕབ་མང་པོས་གཞོམ་པར་མཛོད་༎ རང་བཞིན་ངན་པའི་གནས་པ་དག་གི་འབྲས་མེད་རྩོམ་པའི་འབད་པ་རྣམས་ནི་ཅི་ཡང་མེད་༎
GK19kmeghdpu:108	 tatra vyaktaṃ dṛṣadi caraṇanyāsam ardhendumauleḥ śaśvat siddhair upahṛtabaliṃ bhaktinamraḥ parīyāḥ /	T12D4302:346a-17	དེར་ནི་ཆེ་ཞིང་གསལ་བའི་རྡོལ་གཙུག་ན་ཟླ་ཕྱེད་འཛིན་པའི་རྐང་བཀོད་རྗེས་ལ་ནི་༎ རྟག་ཏུ་གྲུབ་པ་རྣམས་ཀྱིས་གཏོར་མ་མཆོད་ཀྱིས་གུས་པས་ཕྱག་དང་བསྐོར་བ་མཛོད་༎
GK19kmeghdpu:109	 yasmin dṛṣṭe karaṇavigamād ūrdhvam uddhūtapāpāḥ kalpante 'sya sthiragaṇapadaprāptaye śraddadhānāḥ // KMgD_55 //	T12D4302:346a-19	གང་ཞིག་མཐོང་ན་བྱེད་པས་བྱས་པའི་སྡིག་པ་རྣམས་ནི་ཤིན་ཏུ་རིང་པོར་འདོར་བྱེད་ཅིང་༎ གུས་པ་འཛིན་པ་རྣམས་ནི་དེ་ཡི་འཁོར་དུ་གནས་པ་ཐོབ་བྱེད་བརྟན་པ་ཐོབ་པར་འགྱུར་༎
GK19kmeghdpu:110	 śabdāyante madhuram anilaiḥ kīcakāḥ pūryamāṇāḥ saṃraktābhis tripuravijayo gīyate kiṃnarībhiḥ /	T12D4302:346a-21	དྲི་ཞིམ་རྣམས་ཀྱིས་ཁེངས་པར་གྱུར་པའི་ཁང་པ་ནང་ནས་སྙན་པའི་ཡིད་འོང་སྒྲ་འབྱུང་ཞིང་༎ མིའམ་ཅི་མོ་རྣམས་ཀྱིས་གྲོང་ཁྱེར་གསུམ་རྒྱལ་འགྱུར་ལས་ཡང་དག་དགའ་བས་གླུ་དབྱངས་སྒྲོགས་༎
GK19kmeghdpu:111	 nirhrādī te muraja iva cet kandareṣu dhvaniḥ syāt saṃgītārtho nanu paśupates tatra bhāvī samastaḥ // KMgD_56 //	T12D4302:346a-23	རྡ་ཟླུམ་སྙན་པའི་སྒྲ་བཞིན་གལ་ཏེ་ཁྱོད་ཀྱིས་རྡོ་ཡི་གཙུག་ལག་ཁང་དེར་སྒྲ་སྙན་ནི་༎ བསྒྲགས་པར་གྱུར་ན་ངེས་པར་ཕྱུགས་བདག་དྲུང་དུ་གསུམ་འདུས་དབྱངས་སྙན་དོན་གྱི་ཚོགས་པ་འབྱུང་༎
GK19kmeghdpu:128	 haste līlākamalam alakaṃ bālakundānuviddhaṃ nītā lodhraprasavarajasā pāṇḍutām ānanaśrīḥ /  cūḍāpāśe navakuravakaṃ cāru karṇe śirīṣaṃ sīmante ca tvadupagamajaṃ yatra nīpaṃ vadhūnām // KMgD_65 //	T12D4302:347a-10	གདོང་གི་ཆུ་སྐྱེས་འཛུམ་ཞིང་དཀར་བའི་གེ་སར་དབལ་ནི་གསར་པ་དག་གིས་མཛེས་བྱས་ཤིང་༎ གཙུག་ཕུད་ཀུ་རུ་བ་ཀའི་མེ་ཏོག་ཞགས་པས་བཅིངས་པ་མཛེས་ཤིང་རྣ་བར་ཨཽཏཔལ་ཅན་༎ སྐྲ་མཚམས་བཀྲ་བའི་མེ་ཏོག་དག་དང་ལྡན་པའང་ཁྱོད་ནི་ཉེ་བར་འོངས་ལས་སྐྱེས་པ་ཡིན་༎
GK19kmeghdpu:130	 yasyāṃ yakṣāḥ sitamaṇimayāny etya harmyasthalāni jyotiśchāyākusumaracanāny uttamastrīsahāyāḥ /	T12D4302:347a-13	གང་གི་དཀར་པོའི་ནོར་བུ་དང་ལྡན་རིན་ཆེན་འོད་ཀྱིས་ཁྱབ་པ་ཆུ་སྐྱེས་ལྟར་མཛེས་པའི་༎ ཡང་ཐོག་གཞི་ལ་གནོད་སྦྱིན་རྣམས་ནི་མཆོག་གིས་དགའ་མ་དང་བཅས་ཡང་དག་གནས་བྱས་ནས་༎
GK19kmeghdpu:132	 yatra strīṇāṃ priyatamabhujocchvāsitāliṅgitānām aṅgaglāniṃ suratajanitāṃ tantujālāvalambāḥ /  tvatsaṃrodhāpagamaviśadaiś cotitāś candrapādair vyālumpanti sphuṭajalalavasyandinaś candrakāntāḥ // KMgD_67 //  netrā nītāḥ satatagatinā yad vimānāgrabhūmīr ālekhyānāṃ salilakaṇikādoṣam utpādya sadyaḥ /  śaṅkāspṛṣṭā iva jalamucas tvādṛśā yatra jālair dhūmodgārānukṛtinipuṇā jarjarā niṣpatanti // KMgD_68 //	T12D4302:347a-22	མཆོག་ཏུ་ཆེ་བའི་འོད་ཟེར་དང་ལྡན་རིན་ཆེན་མར་མེ་མངོན་དུ་མཐོང་བར་བྱེད་པ་ནི་༎ གང་དུ་ཆུ་འཛིན་ས་སྟེང་གནས་རྣམས་འདྲེན་བྱེད་རྟག་འགྲོས་གཞལ་མེད་ཁང་ནང་ངེད་པ་ན་༎ གང་ཞིག་རང་གི་ཆུ་ཐིགས་དག་གིས་བཀྲ་བའི་རི་མོ་རྣམས་ལ་འཕྲལ་དུ་སྐྱོན་བྱུང་ནས་༎ ངོ་ཚ་རེག་བ་བཞིན་དུ་ཁྱོད་འདྲ་དུམ་བུ་དུམ་བུ་དག་ཏུ་འཐོན་པར་བྱེད་པ་ནི་༎ དྲ་མིག་རྣམས་ཀྱི་ནང་ནས་དུ་བཞུགས་པ་འཐོན་པ་རྣམས་ཀྱི་རྗེས་སུ་བྱེད་པ་བཞིན་༎
GK19kmeghdpu:136	 nīvībandhocchvasitaśithilaṃ yatra yakṣāṅganānāṃ vāsaḥ kāmād anibhṛtakareṣv ākṣipatsu priyeṣu /	T12D4302:347b-5	གང་དུ་བུད་མེད་མཆོག་རྣམས་བདག་པོ་མཆོག་གིས་ཀུན་ནས་འཁྱུད་པ་རྣམས་ནི་བཏང་བ་ན་༎ ལུས་ནི་ཀུན་ནས་གདུང་བར་བྱེད་ལ་ཟླ་བ་ཆུ་ཤེལ་སྲད་བུའི་དྲ་བ་འཕྱང་བ་ཅན་༎
GK19kmeghdpu:137	 arcistuṅgān abhimukham api prāpya ratnapradīpān hrīmūḍhānāṃ bhavati viphalapreraṇā cūrṇamuṣṭiḥ // KMgD_69 //	T12D4302:347b-7	ཁྱོད་ཀྱིས་བསྒྲིབས་པ་མེད་ཅིང་དཀར་བའི་ཟླ་བའི་འོད་རྣམས་གསལ་བར་མཐོང་པར་གྱུར་པ་ན་༎ ཆུ་ཐིགས་འབབ་པ་ཀུན་ནས་བྱུགས་པས་ཞི་བར་བྱེད་ཅིང་མཆོག་ཏུ་དགའ་བ་སྐྱེད་པ་ཉིད་༎
GK19kmeghdpu:138	 gatyutkampād alakapatitair yatra mandārapuṣpaiḥ patracchedaiḥ kanakakamalaiḥ karṇavibhraṃśibhiś ca /  muktājālaiḥ stanaparicitacchinnasūtraiś ca hārair naiśo mārgaḥ savitur udaye sūcyate kāminīnām // KMgD_70 //  matvā devaṃ dhanapatisakhaṃ yatra sākṣād vasantaṃ prāyaś cāpaṃ na vahati bhayān manmathaḥ ṣaṭpadajyam /	T12D4302:347b-9	གང་དུ་གནོད་སྦྱིན་བདག་པོའི་གྲོགས་བཟང་ལྷ་ཉིད་མངོན་སུམ་ཉིད་དུ་གནས་པ་ཤེས་བྱས་ནས་༎ འཇིགས་པ་མང་ལས་ཡིད་སྲུབས་གཞུ་ནི་རྐང་དྲུག་པ་ཡི་གཞུ་རྒྱུད་ཅན་དེ་དོར་བས་ཆོག་། བདག་པའི་འབེན་ལ་མཛེས་མའི་སྨིན་མ་འཁྱོག་པོའི་གཞུ་ལ་ཟུར་མིག་ག-ཡོ་བ་དག་གི་མདའ་༎
GK19kmeghdpu:141	 sabhrūbhaṅgaprahitanayanaiḥ kāmilakṣyeṣv amoghais tasyārambhaś caturavanitāvibhramair eva siddhaḥ // KMgD_71 //	T12D4302:347b-11	རོལ་སྒེག་ག-ཡོ་བརྩོམ་པར་བྱེད་པ་ཉིད་ཀྱིས་དེ་ཡི་འབྲས་བུ་ངེས་པར་གྲུབ་པ་ཉིད་༎
GK19kmeghdpu:142	 tatrāgāraṃ dhanapatigṛhād uttareṇāsmadīyaṃ dūrāl lakṣyaṃ tad amaradhanuś cāruṇā toraṇena /	T12D4302:347b-12	དེ་ན་ནོར་གྱི་བདག་པའི་ཁང་བཟངས་ལས་ནི་བྱང་གི་ཕྱོགས་ན་བདག་གི་གྲོང་ཁྱེར་ནི་༎ མཐོ་རིས་བདག་པོའི་གཞུ་དང་འདྲ་བའི་རྟ་བབས་མཛེས་པས་རིང་ནས་འཚམ་པར་བྱས་པ་སྟེ་༎
GK19kmeghdpu:143	 yasyodyāne kṛtakatanayaḥ kāntayā vardhito me hastaprāpyastabakanamito bālamandāravṛkṣaḥ // KMgD_72 //	T12D4302:347b-14	གང་གི་སྐྱེད་ཚལ་མནདར་དང་ལྗོན་ཤིང་གཞོན་ནུ་བདག་གི་མཛེས་མའི་བུ་ལྟར་ནི་༎ བསྐྱངས་པའི་མཐུ་ལས་འཕེལ་བའི་མེ་ཏོག་ཆུན་འཕྱང་ཐུར་དུ་འཕྱང་བ་ལག་པས་ཐོབ་བྱ་ཡོད་༎
GK19kmeghdpu:144	 vāpī cāsmin marakataśilābaddhasopānamārgā haimaiḥ syūtā kamalamukulaiḥ snigdhavaiḍūryanālaiḥ /	T12D4302:347b-16	བཀོང་མ་བཟང་མོའི་ཆུ་ནི་མར་ཀ་ཏའི་རྡོ་ཡི་ཕྲིང་བ་བསྒྲིགས་པའི་ལམ་སྐས་ཅན་༎ འདི་ནས་མཛེས་པའི་གསེར་གྱི་པདམ་རྒྱས་པ་རིན་ཆེན་རྩ་ལྡན་རྣམས་ཀྱིས་ཁྱབ་པ་སྟེ་༎
GK19kmeghdpu:145	 yasyās toye kṛtavasatayo mānasaṃ saṃnikṛṣṭaṃ nādhyāsyanti vyapagataśucas tvām api prekṣya haṃsāḥ // KMgD_73 //	T12D4302:347b-18	གདུང་བ་དང་བྲལ་ངང་བའི་ཚོགས་རྣམས་དག་ནི་གངགའའི་ཆུ་ལ་གནས་པར་བྱས་པའི་ཚེ་༎ ཁྱོད་ཉིད་ཡང་དག་མཐོང་བར་གྱུར་ཀྱང་ཉེ་བར་གནས་པའི་ཡིད་འོང་མཚོ་ལས་འགྲོ་མི་འགྱུར་༎
GK19kmeghdpu:146	 tasyās tīre racitaśikharaḥ peśalair indranīlaiḥ krīḍāśailaḥ kanakakadalīveṣṭanaprekṣaṇīyaḥ /	T12D4302:347b-20	ཀབ༹་ཡེ་གྲོགས་བཟང་ཁྱོད་ནི་གློག་གི་དག་འམ་ག-ཡོ་བཞིན་ཉེ་བར་མཐོང་བར་གྱུར་པ་ན་༎ མཚོ་དེའི་དོགས་ན་མཛེས་པའི་རི་བོ་ཡིད་འོང་མཆོག་གི་ཨཻནདྲ་ནའི་ལ་རྣམས་ཀྱིས་ནི་༎
GK19kmeghdpu:147	 madgehinyāḥ priya iti sakhe cetasā kātareṇa prekṣyopāntasphuritataḍitaṃ tvāṃ tam eva smarāmi // KMgD_74 //	T12D4302:347b-22	རྩེ་མོ་མཛེས་པར་བྱས་པར་གསར་གྱི་བསྐོར་བ་རྣམས་ཀྱིས་བསྐོར་བ་ཁྱོད་ཀྱིས་བལྟ་བྱ་བ་། བདག་གི་དགའ་མ་དགའ་བྱེད་༄༣༤༨ཨ་༌་༎ དང་བཅས་དེ་ཉིད་སེམས་གདུངས་བདག་ནི་ཤིན་ཏུ་དྲན་པར་གྱུར་༎
GK19kmeghdpu:148	 raktāśokaś calakisalayaḥ kesaraś cātra kāntaḥ pratyāsannau kuravakavṛter mādhavīmaṇḍapasya /	T12D4302:348a-2	དེ་ལ་ཀུ་རུ་བ་ཀའི་ཤིང་གིས་བསྐོར་བའི་ཡལ་གའི་ཁང་བཟངས་དང་ལྡན་ཉེ་བ་ན་༎ མྱ་ངན་མེད་ཤིང་དམར་དང་ཀེ་ས་ར་ཡི་ཤིང་ཆེན་ཡལ་འདབ་ག-ཡོ་བ་མཛེས་པ་ཡོད་༎
GK19kmeghdpu:149	 ekaḥ sakhyās tava saha mayā vāmapādābhilāṣī kāṅkṣaty anyo vadanamadirāṃ dohadacchadmanāsyāḥ // KMgD_75 //	T12D4302:348a-4	གཅིག་ལ་ཁྱོད་ཀྱི་གྲོགས་སུ་གྱུར་བའི་དགའ་མ་བདག་དང་བཅས་པའི་ག-ཡོན་པས་བསྒྲུན་འདོད་ཅིང་༎ གཞན་ལ་གདོང་གི་ཆང་འཐུངས་མེ་ཏོག་འབྱུང་བའི་དོན་དུ་དགའ་མ་དེ་ནི་བདག་འདོད་གྱུར་༎
GK19kmeghdpu:150	 tanmadhye ca sphaṭikaphalakā kāñcanī vāsayaṣṭir mūle baddhā maṇibhir anatiprauḍhavaṃśaprakāśaiḥ /	T12D4302:348a-6	དེ་ཡི་དབུས་ན་རབ་དཀར་ཤེལ་གྱི་གཞལ་གསེར་གྱི་སྡོང་པོ་ཆེ་ཞིང་མཐོ་བར་གནས་༎ རྩ་བ་རིན་ཆེན་ཕྲེང་བས་བཅིངས་པ་རྡོ་རྗེ་ཕ་ལམ་ཆེ་བ་མིན་པ་འོད་འཕྲོ་བ་༎
GK19kmeghdpu:151	 tālaiḥ śiñjadvalayasubhagair nartitaḥ kāntayā me yām adhyāste divasavigame nīlakaṇṭhaḥ suhṛd vaḥ // KMgD_76 //	T12D4302:348a-8	གང་ལ་ཁྱོད་ཀྱི་གྲོགས་བཟང་མགྲིན་སྔོན་གནས་ནས་ཉིན་ཕྱེད་སོང་ཚེ་རོལ་སྒེག་གར་བྱེད་ཅིང་༎ བདག་གི་མཛེས་མ་རིན་ཆེན་གདུ་བུ་འཐབ་པའི་དབྱངས་སྙན་སྐལ་བཟང་མཆོག་ཏུ་མཛེས་པ་ཡོད་༎
GK19kmeghdpu:152	 ebhiḥ sādho hṛdayanihitair lakṣaṇair lakṣayethā dvāropānte likhitavapuṣau śaṅkhapadmau ca dṛṣṭvā /	T12D4302:348a-10	དེ་རྣམས་ཀྱིས་ནི་ལེགས་པར་མཚན་པ་ཀབ༹་ཡེ་ལེགས་པའི་ཐུགས་འཛིན་ཁྱོད་ཀྱིས་བལྟ་བར་བྱ་༎ སྒོ་ཡི་མཐའ་དང་ཉེ་བ་དག་ན་དུང་དང་པདམའི་གཟུགས་བྲིས་མཐོང་བར་བྱས་པ་ན་༎
GK19kmeghdpu:153	 kṣāmacchāyaṃ bhavanam adhunā madviyogena nūnaṃ sūryāpāye na khalu kamalaṃ puṣyati svām abhikhyām // KMgD_77 //	T12D4302:348a-12	ད་ལྟ་བདག་དང་བྲལ་བར་གྱུར་པས་ངེས་པར་མཛེས་པ་དམན་པ་ཉིད་དུ་གནས་པར་ངེས་༎ ཉི་མ་ནུབ་བར་གྱུར་པས་ངེས་པར་པདམ་དག་གིས་མཛེས་པ་ཉམས་པར་གྱུར་པ་ཉིད་༎
GK19kmeghdpu:154	 gatvā sadyaḥ kalabhatanutāṃ śīghrasaṃpātahetoḥ krīḍāśaile prathamakathite ramyasānau niṣaṇṇaḥ /	T12D4302:348a-14	མཛེས་མ་དེ་ནི་ཡོངས་སུ་བསྐྱངས་ཆེད་མྱུར་དུ་གཤེགས་ནས་གླང་ཕྲུག་ལུས་བཞིན་ཆུང་བ་ཡིས་༎ མཛེས་པའི་རི་བོ་དེ་ཡི་ངོས་ལ་གནས་ནས་དང་པོར་ལེགས་བཤད་སྙན་པའི་གསུང་གླེང་མཛོད་༎
GK19kmeghdpu:21	 ā kailāsād bisakisalayacchedapātheyavantaḥ saṃpatsyante nabhasi bhavato rājahaṃsāḥ sahāyāḥ // KMgD_11 //	T12D4302:342a-19	ཁྱོད་ནི་ནམ་མཁའ་དག་ལ་གཤེགས་ཚེ་དགའ་བའི་ཡིད་ཀྱིས་མཚོ་དང་གངས་ཅན་བར་ལ་ནི་༎ པདམའི་རྩ་བ་ལོ་མའི་ལམ་རྒྱགས་ལྡན་པའི་ངང་པའི་རྒྱལ་པོ་རྣམས་ཀྱང་གྲོགས་སུ་འགྱུར་།
GK19kmeghdpu:22	 āpṛcchasva priyasakham amuṃ tuṅgam āliṅgya śailaṃ vandyaiḥ puṃsāṃ raghupatipadair aṅkitaṃ mekhalāsu /	T12D4302:342b-0	རགྷུའི་བདག་པོའི་ཞབས་ཀྱིས་མཚན་པའི་རི་ངོས་རྣམས་ལ་སྐྱེ་༄༣༤༢བ་བོ་ཀུན་གྱི་ས་ཕྱག་བྱེད་པའི་༎ ཆེ་བའི་རི་བོ་འདི་ནི་ཁྱོད་ཀྱི་དགའ་བའི་གྲོགས་བཟང་ཁྱོད་ལང་འཁྱུད་བ་སྔོན་འགྲོ་བའི་༎
GK19kmeghdpu:23	 kāle kāle bhavati bhavatā yasya saṃyogam etya snehavyaktiś ciravirahajaṃ muñcato bāṣpam uṣṇam // KMgD_12 //	T12D4302:342b-2	མཛའ་བ་གསལ་བྱས་ཡུན་རིང་འབྲལ་ལས་བྱུང་བའི་མཆི་མའི་དྲོ་བའང་འབྱུང་བ་ཡོངས་མཐོང་ལ་༎ ཁྱོད་དང་གང་དེ་དུས་དུས་དག་ཏུ་ཡང་དག་མཇལ་འགྱུར་ཞེས་ནི་བྱས་ནས་ཁམས་བདེ་མཛོད་༏
GK19kmeghdpu:24	 mārgaṃ tāvac chṛṇu kathayatas tvatprayāṇānurūpaṃ saṃdeśaṃ me tadanu jalada śroṣyasi śrotrapeyam /	T12D4302:342b-4	། ཀབ༹་ཡེ་ཆུ་འཛིན་རེ་ཞིག་ཁྱོད་ནི་ལམ་ལ་བགྲོད་པའི་ཐབས་ཀྱིས་གཏམ་ནི་མཉན་པར་མཛོད་༎ དེ་ཡི་རྗེས་སུ་བདག་གི་འཕྲིན་ནི་རྣ་བའི་བདེ་བ་སྐྱེད་ཁྱོད་རྣ་བར་གཟུང་བར་མཛོད་༎
GK19kmeghdpu:25	 khinnaḥ khinnaḥ śikhariṣu padaṃ nyasya gantāsi yatra kṣīṇaḥ kṣīṇaḥ parilaghu payaḥ srotasāṃ copabhujya // KMgD_13 //	T12D4302:342b-6	ཤིན་ཏུ་ངལ་ཞིང་རབ་ཏུ་ངལ་ཚེ་རི་བོའི་རྩེ་ལ་རྐང་བཀོད་ངལ་བ་བསལ་ནས་གཤེགས་༎ གང་དུ་སྐོམ་ཤིང་ཤིན་ཏུ་སྐོམ་ན་ཉུང་དུའི་ཆུ་དང་ཆེ་བའི་མཚོལ་འང་བཏུང་བར་བྱ་༎
GK19kmeghdpu:26	 adreḥ śṛṅgaṃ harati pavanaḥ kiṃ svid ity unmukhībhir dṛṣṭotsāhaś cakitacakitaṃ mugdhasiddhāṅganābhiḥ /  sthānād asmāt sarasaniculād utpatodaṅmukhaḥ khaṃ diṅnāgānāṃ pathi pariharan sthūlahastāvalepān // KMgD_14 //  ratnacchāyāvyatikara iva prekṣyam etat purastād valmīkāgrāt prabhavati dhanuḥkhaṇḍam ākhaṇḍalasya /	T12D4302:342b-8	ནི་ཙུ་ལ་ནི་གསར་བས་གནས་འདི་ལས་ནི་ཁྱོད་ལངས་མཁའ་ལ་བྱང་དུ་གདོང་ཕྱོགས་མཛོད་༎ ཕྱོགས་ཀྱི་གླང་པོ་རྣམས་ཀྱི་ལག་པ་ཆེ་བས་བཅིངས་པའི་ལམ་ནི་ཡོངས་སུ་དོར་བར་གྱིས་༎ རི་ཡི་རྩེ་མོ་ཕྲོགས་ནས་དྲི་བཞོན་འགྲོ་བའམ་ཆུ་འཛིན་ལངས་ནས་འགྲོ་བའི་ཅི་ཞེས་ཐེ་ཚོམ་དུ་༎ གྱུར་ནས་གྲུབ་པའི་བུད་མེད་རྣམས་ཀྱིས་གྱེན་ཕྱོགས་བལྟས་ཏེ་འཇིགས་ཤིང་སྐྲག་པས་རྨོངས་བར་འགྱུར་༎
GK19kmeghdpu:29	 yena śyāmaṃ vapur atitarāṃ kāntim āpatsyate te barheṇeva sphuritarucinā gopaveṣasya viṣṇoḥ // KMgD_15 //	T12D4302:342b-12	རིན་ཆེན་འོད་ཀྱིས་སྣང་བ་བཞིན་དུ་རབ་མཛེས་མཆོད་སྦྱིན་བརྒྱ་པའི་གཞུ་ཡི་དུམ་བུ་ནི་༎ ཆེ་བའི་གྲོག་མཁར་རྩེ་ལས་བྱུང་བ་དེ་ནི་མདུན་དུ་ཡང་དག་མཐོང་བར་འགྱུར་༏
GK19kmeghdpu:38	 tasyās tiktair vanagajamadair vāsitaṃ vāntavṛṣṭir jambūkuñjapratihatarayaṃ toyam ādāya gaccheḥ /	T12D4302:343a-13	ཁྱོད་ཀྱིས་ཐོག་མར་ཆར་པ་སྒྱུག་བྱ་དེ་ཡི་ཆུ་ནི་འཐུངས་ནས་བགྲོད་པར་བྱ་སྟེ་ཕྱིན་ནས་ནི་༎ ནགས་ཀྱི་གླང་པོ་མྱོས་པའི་ཏིག་ཏའི་རོ་དང་འཛམ་བུའི་ཤིང་གི་ཆུ་དེའང་མྱུར་དུ་འགེངས་༎
GK19kmeghdpu:39	 antaḥsāraṃ ghana tulayituṃ nānilaḥ śakṣyati tvāṃ riktaḥ sarvo bhavati hi laghuḥ pūrṇatā gauravāya // KMgD_20 //	T12D4302:343a-15	ཀབ༹་ཡེ་སྦྲིན་སྟུག་ཁྱོད་ནི་ནང་གི་སྙིང་པོ་ལྡན་ན་དྲི་བཞོན་དག་གིས་ག-ཡོ་མི་ནུས་༎ གང་ཕྱིར་ཐམས་ཅད་སྟོང་ན་ཡང་བར་འགྱུར་ཞིང་ཡོངས་སུ་གང་ན་ཀུན་ཀྱང་ལྗི་བ་ཉིད་༎
GK19kmeghdpu:40	 nīpaṃ dṛṣṭvā haritakapiśaṃ kesarair ardharūḍhair āvirbhūtaprathamamukulāḥ kandalīś cānukaccham /	T12D4302:343a-17	དང་པོར་ཀནདལི་ཡི་མེ་ཏོག་ཁ་འབུས་རྣམས་ནི་ཤུན་པས་བསྒྲིབས་པ་བྱུང་བ་དང༎ འདབ་མ་ལྗང་ཞིང་གེ་སར་དཀར་སེར་ཕྱེ་ལྡན་བརྟན་པ་རྣམས་ཀྱི་ཆུ་སྐྱེས་མེ་ཏོག་མཐོང་ནས་ཀྱང་༎
GK19kmeghdpu:41	 dagdhāraṇyeṣv adhikasurabhiṃ gandham āghrāya corvyāḥ sāraṅgās te jalalavamucaḥ sūcayiṣyanti mārgam // KMgD_21 //	T12D4302:343a-19	ཆུ་འཛིན་དལ་བུས་ཆར་བསྐྲུན་ཁྱོད་ལ་སའ་རིགས་རྣམས་ནི་སྟོན་པར་བྱེད་པར་འགྱུར་༎ ཙའུ་ཏ་ཀ་རྣམས་ཆུ་ཡི་ཐིགས་པ་བཟུང་ནས་དགའ་བས་འཐུང་ལ་ལྟ་བར་བྱེད་བཞིན་དང་༎ ཆུ་སྒྲོགས་རྣམས་ནི་ཕྲིང་བར་བསྒྲིགས་རྣམས་ཡོངས་སུ་བསྒྲེང་ཞིང་ཅི་ཞེས་ངེས་པར་ལྟ་བཞིན་དང་༎ མཆོག་ཏུ་འདར་བྱས་དགའ་བས་དགའ་མ་ལ་ནི་༄༣༤༣བ་དམ་དུ་འཁྱུད་པ་རྣམས་ནི་བྱེད་པ་ཡིན་༎ ཀ་ཀུ་བྷ་ཡི་དྲི་ལྡན་རི་བོ་རི་བོ་རྣམས་ལ་ཡུན་རིང་ཐོགས་པར་བདག་གིས་ཤེས་༎ གཙུག་པུད་ཅན་གྱི་འདྲེན་བྱེད་ཆུ་དང་བཅས་པས་ལེགས་པར་འོངས་སམ་བྱས་ནས་ཡུན་རིང་གནས་པར་འདོད་༎
GK19kmeghdpu:43	 śuklāpāṅgaiḥ sajalanayanaiḥ svāgatīkṛtya kekāḥ pratyudyātaḥ katham api bhavān gantum āśu vyavasyet // KMgD_22 //  pāṇḍucchāyopavanavṛtayaḥ ketakaiḥ sūcibhinnair nīḍārambhair gṛhabalibhujām ākulagrāmacaityāḥ /  tvayy āsanne pariṇataphalaśyāmajambūvanāntāḥ saṃpatsyante katipayadinasthāyihaṃsā daśārṇāḥ // KMgD_23 //	T12D4302:343b-5	ཁྱོད་འོངས་ཚེ་ན་ངང་པ་རྣམས་ནི་དེ་ཉིད་ཅུང་ཟད་གནས་ནས་འགྲོ་ཞིང་འབྲས་བུ་ནི་༎ ཡོངས་སུ་སྨིན་པ་ལྗང་སྔོན་དང་ལྡན་འཛམ་བུའི་ནགས་ཀྱིས་བསྐོར་དབུས་དཀར་པོའི་འོད་ལྡན་ཆེ་བ་ཡི་༎ ནགས་ཀྱི་འཁྲི་ཤིང་ཀེ་ཏའི་ཆུ་སྐྱེས་གེ་སར་གསལ་བར་རྒྱས་ཤིང་གྲོང་དང་མཆོད་རྟེན་གྱིས་༎ བསྐོར་བའི་ཁང་པར་གཏོར་ལེན་ཚང་སྐྱེད་རྩོམ་པའི་གྲོང་ཁྱེར་ཏམ་ཤ་ཞེས་པས་མཆོད་པར་འགྱུར་༎
GK19kmeghdpu:46	 teṣāṃ dikṣu prathitavidiśālakṣaṇāṃ rājadhānīṃ gatvā sadyaḥ phalam api mahat kāmukatvasya labdhā /	T12D4302:343b-9	དེ་ཡི་བྱང་ཕྱོགས་གཞི་ལ་བི་དི་ཤ་ཞེས་མཆོད་ཆ་རྒྱལ་པོའི་ཁབ་ཏུ་མྱུར་སོང་ནས་༎ དེར་ནི་ཁྱོད་ཀྱིས་ཤིན་ཏུ་ཆེ་བའི་འབྲས་བུ་ཐོབ་མཆོག་གོ་འཕང་འཕྲལ་ལ་ཐོབ་འགྱུར་ཞིང་༎
GK19kmeghdpu:47	 tīropāntastanitasubhagaṃ pāsyasi svādu yat tat sabhrūbhaṅgaṃ mukham iva payo vetravatyāś calormi // KMgD_24 //  nīcairākhyaṃ girim adhivases tatra viśrāmahetos tvatsamparkāt pulakitam iva prauḍhapuṣpaiḥ kadambaiḥ /  yaḥ paṇyastrīratiparimalodgāribhir nāgarāṇām uddāmāni prathayati śilāveśmabhir yauvanāni // KMgD_25 //	T12D4302:343b-11	ཆེ་བའི་ཁ་ཞེང་དང་ལྡན་མཐའ་ནས་ལྷུང་ལྷུང་སྐད་སྙན་སྒྲོགས་ཤིང་དང་ཞིང་བསིལ་ལྡན་པ་༎ ག-ཡོ་བའི་རླབས་ཕྲེང་གདོང་ཁ་སྨིན་མ་ག-ཡོ་བཞིན་པ་འདྲའི་མཚོ་དེའང་སྐལ་བཟང་ཁྱོད་འཐུང་འགྱུར་༎ གང་ཞིག་ནི་ཙ་ཞེས་གྲགས་རི་བོར་ཁྱོད་འོངས་ཐོབ་ལས་དེར་ནི་ངལ་བསོའི་ཆེད་དུ་གནས་༎ ཀ་དམ་པ་ཡི་མེ་ཏོག་དགའ་བས་སྤུ་ལོང་རྒྱས་ཤིང་གེ་སར་འཛུམ་པར་བྱེད་པ་བཞིན་༎ གྲོང་ཁྱེར་རྣམས་ནི་སྨན་འཚོང་མ་རྣམས་དགའ་བར་བྱེད་པའི་དྲི་བཟངས་དག་གིས་གང་བ་རྣམས་༎
GK19kmeghdpu:50	 viśrāntaḥ san vraja vananadītīrajātāni siñcann udyānānāṃ navajalakaṇair yūthikājālakāni /  gaṇḍasvedāpanayanarujāklāntakarṇotpalānāṃ chāyādānāt kṣaṇaparicitaḥ puṣpalāvīmukhānām // KMgD_26 //	T12D4302:343b-16	རྡོ་ཡི་ཕྲག་ཕྲུག་རྣམས་ཀྱི་མཆོག་ཏུ་མཛེས་བའི་ལང་ཚོམ་རྣམས་སྨྲ་རུ་འཇུག་པ་བཞིན་༎ ངལ་སོས་གྱུར་ན་བགྲོང་བྱ་གསར་སྐྱེས་རྣམས་ཀྱི་མེ་ཏོག་གསར་པའི་དྲ་བ་མཛེས་པ་རྣམས་༎ ཆུ་བོ་ཆུ་ངོགས་སྐྱེས་པ་རྣམས་ནི་ཆུ་ཐིགས་རྣམས་ཀྱིས་བྲན་པ་འཕྲལ་དུ་འོངས་འགྱུར་ཞིང་༎ ཆུ་སྐྱེས་ཐོག་མའི་གདོང་གི་འགྲམ་པའི་རྡུལ་ཐིགས་སེར་ལ་རྣ་བའི་ཨཽཏཔལ་ངལ་བ་དང་༎ རྙིངས་གྱུར་ལ་ནི་ཉིད་ཀྱིས་སྐད་ཅིག་བདེ་བའི་གྲིབ་བསིལ་ཡོངས་སུ་གནང་བར་མཛོད་ཅིག་ཀྱེ་༎
GK19kmeghdpu:52	 vakraḥ panthā yad api bhavataḥ prasthitasyottarāśāṃ saudhotsaṅgapraṇayavimukho mā sma bhūr ujjayinyāḥ /  vidyuddāmasphuritacakitais tatra paurāṅganānāṃ lolāpāṅgair yadi na ramase locanair vañcito 'si // KMgD_27 //	T12D4302:343b-20	ཡང་ནི་བྱང་གི་ཕྱོགས་སུ་བགྲོད་ཅིང་གང་ཞིག་ཁྱེད་ནི་འཁྱོག་པོའི་ལམ་ལ་ཞུགས་པའི་ཚེ་༎ གྲོང་ཁྱེར་ཨཽཛཛ་ཡ་ནའི་རྒྱལ་པོའི་ཕོ་བྲང་ནང་དུ་ཕྱིར་ཕྱོགས་མིན་པར་གནས་པར་མཛོད་༎ དེ་ན་གྲོང་གི་དགའ་མ་རྣམས་ཀྱི་རོལ་སྒེག་ཟུར་མིག་གློག་གི་༄༣༤༤ཨ་༌་༎ ཐག་པ་ག-ཡོ་བ་ནི་༎ སྐྱོང་བྱེད་མིག་གིས་གལ་ཏེ་ཁྱོད་ནི་མ་མཐོང་འབྲས་བུ་མེད་ཅིང་བསླུས་པ་ཉིད་དུ་འང་འགྱུར་༎
GK19kmeghdpu:54	 vīcikṣobhastanitavihagaśreṇikāñcīguṇāyāḥ saṃsarpantyāḥ skhalitasubhagaṃ darśitāvartanābheḥ /	T12D4302:344a-3	རླབས་ཕྲེང་ག-ཡོ་ལྡན་སྙན་པར་སྒྲོགས་ཤིང་འདབ་ཆགས་ཕྲེང་བའི་རྐེད་རྒྱན་སྐ་རགས་སིལ་སིལ་ཅན་༎ དལ་གྱིས་དལ་གྱིས་འགྲོ་ཞིང་ལང་ལིང་མཛེས་པའི་སྐལ་བཟང་འཁོར་ལོའི་ལྟེ་བ་དང་ལྡན་པ་༎ རོ་མཆོག་དང་ལྡན་ཆུ་བོའི་ན་ཆུང་བིར་བིནདྷ་ནི་ཁྱོད་ནི་ལམ་ན་མངོན་བཞུགས་ནས་༎
GK19kmeghdpu:55	 nirvindhyāyāḥ pathi bhava rasābhyantaraḥ saṃnipatya strīṇām ādyaṃ praṇayavacanaṃ vibhramo hi priyeṣu // KMgD_28 //	T12D4302:344a-6	དགའ་མ་རྣམས་ཀྱིས་མཛའ་བོ་རྣམས་ལ་རོལ་སྒེག་ཐོག་མར་སྟོན་ཅིང་རྐེད་རྒྱན་འགྲོལ་འདྲ་མཐོའ་༎
GK19kmeghdpu:56	 veṇībhūtapratanusalilā tām atītasya sindhuḥ pāṇḍucchāyā taṭaruhatarubhraṃśibhir jīrṇaparṇaiḥ /	T12D4302:344a-7	དེ་རྒལ་སིནདྷུའི་ཆུ་ནི་ལེན་བུ་བཞིན་དུ་ལུས་ནི་རབ་ཏུ་ཕྲ་བར་གྱུར་པ་ཅན་༎ དགོས་སུ་གྱུར་པའི་ཤིང་ནི་རྙིངས་པའི་འདབ་མ་ལྷུང་བ་རྣམས་ཀྱིས་ཁྱབ་པར་བཀྲམ་པས་དཀར་༎
GK19kmeghdpu:57	 saubhāgyaṃ te subhaga virahāvasthayā vyañjayantī kārśyaṃ yena tyajati vidhinā sa tvayaivopapādyaḥ // KMgD_29 //	T12D4302:344a-9	ཀབ༹་ཡེ་སྐལ་བཟང་ཁྱོད་དང་བྲལ་བར་གནས་པས་ལུས་ཀྱི་གནས་སྐབས་འདི་འདྲར་འགྱུར་༎ གང་གི་ཆུང་མ་སྤངས་ནས་ཆེ་བའི་གནས་སྐབས་མཛད་དམ་ཁྱོད་མཁྱེན་དེ་ནི་རྗོད་པར་བྱེད་༎
GK19kmeghdpu:58	 prāpyāvantīn udayanakathākovidagrāmavṛddhān pūrvoddiṣṭām anusara purīṃ śrīviśālāṃ viśālām /	T12D4302:344a-11	ཨཨ་ཝནཏའི་ཡུལ་ཐོག་ན་ཨཽ་ད་ཡ་ནའི་གཏམ་ནི་གྲོང་གི་རྒན་མོས་ཤེས་པ་ཡོད་༎ དེ་རྗེས་གྲོང་ཁྱེར་སྔར་བསྟན་ཁང་པ་ཡངས་ཤིང་དཔལ་དང་ཕུན་ཚོགས་ཆེ་ལྡན་ཡངས་པ་ཅན་༎
GK19kmeghdpu:59	 svalpībhūte sucaritaphale svargiṇāṃ gāṃ gatānāṃ śeṣaiḥ puṇyair hṛtam iva divaḥ kāntimat khaṇḍam ekam // KMgD_30 //	T12D4302:344a-13	འཛམ་གླིང་ས་གཞིར་མཐོ་རིས་མཛེས་ལྡན་དུམ་བུ་བསོད་ནམས་ལྷག་མ་རྣམས་ཀྱི་སྐབས་གསུམ་པའི་༎ ལེགས་བཤད་འབྲས་བུར་གྱུར་པ་ཉུང་ཤས་འགའ་ཞིག་དག་ནི་ཕྲོགས་ནས་འོངས་པར་གྱུར་པ་བཞིན་༎
GK19kmeghdpu:60	 dīrghīkurvan paṭu madakalaṃ kūjitaṃ sārasānāṃ pratyūṣeṣu sphuṭitakamalāmodamaitrīkaṣāyaḥ /  yatra strīṇāṃ harati surataglānim aṅgānukūlaḥ siprāvātaḥ priyatama iva prārthanācāṭukāraḥ // KMgD_31 //  jālodgīrṇair upacitavapuḥ keśasaṃskāradhūpair bandhuprītyā bhavanaśikhibhir dattanṛttopahāraḥ /	T12D4302:344a-15	གང་དུ་བཞད་རྣམས་མྱོས་པའི་གདངས་སྙན་ཆེ་བར་སྒྲོགས་ཤིང་ཡིད་འོང་སྒྲ་ནི་གསལ་བར་བྱེད་༎ ཉི་གཞོན་གྱིས་རྒྱས་ཆུ་སྐྱེས་དྲི་བཟངས་དགའ་སྐྱེད་བསྐ་བའི་རོ་ལྡན་ཡིད་དུ་འོང་གྱུར་ཅིང་༎ ཆུ་ཐིགས་ཀྱིས་བྲན་དྲི་བཞོན་བུད་མེད་ཆགས་གཟིར་གདུང་བ་ཕྲོག་བྱེད་ལུས་ཀྱི་རྗེས་མཐུན་པ་༎ བདག་བོ་མཆོག་ནི་འདོད་དོན་གཉེར་བར་བྱེད་ལ་སྙན་པར་སྒྲོགས་ཤིང་དགའ་བར་བྱེད་པ་བཞིན་༎
GK19kmeghdpu:63	 harmyeṣv asyāḥ kusumasurabhiṣv adhvakhinnāntarātmā nītvā rātriṃ lalitavanitāpādarāgāṅkiteṣu // KMgD_32 //	T12D4302:344a-19	དེ་ཡི་ནོར་ལྡན་ཁང་པ་རྣམས་ན་ལེན་བུ་སྤོས་ཀྱིས་བདུགས་པའི་དྲི་བཟངས་དྲ་བ་ནས་༎ འཐོན་པས་ཁྱོད་ལུས་ཆེར་འགྱུར་ཁྱིམ་གྱི་གཅུག་པུད་ཅན་ནི་དགའ་བས་གཉེན་མཐོང་གར་གྱིས་ནི་༎ མཆོད་འབུལ་ཆུ་སྐྱེས་དྲི་བཟངས་ལྡན་པ་བུད་མེད་རོལ་སྒེག་ལྡན་པའི་རྐང་པའི་ཚོན་རྣམས་ཀྱིས་༎ མཚན་པ་རྣམས་ཀྱི་དབུས་སུ་དུབ་པར་གྱུར་པའི་རང་ཉིད་སྡུག་བསྔལ་བསལ་བར་བྱ་༎
GK19kmeghdpu:64	 bhartuḥ kaṇṭhacchavir iti gaṇaiḥ sādaraṃ vīkṣyamāṇaḥ puṇyaṃ yāyās tribhuvanaguror dhāma caṇḍeśvarasya /	T12D4302:344a-23	ཡང་ནི་སྲིད་པ་གསུམ་གྱི་བླ་མ་དཔལ་མགྲིན་གནས་སུ་བསོད་ནམས་ལྡན་ཁྱོད་བགྲོད་པར་བྱ་༎ འཁོར་ཚོགས་ཆོས་ཀྱིས་༄༣༤༤བ་ཁྱབ་བདག་མགྲིན་འོད་མཚུངས་བཞིན་ཞེས་གུས་དང་བཅས་པས་ལྟ་བར་བྱེད་༎
GK19kmeghdpu:65	 dhūtodyānaṃ kuvalayarajogandhibhir gandhavatyās toyakrīḍāniratayuvatisnānatiktair marudbhiḥ // KMgD_33 //	T12D4302:344b-1	ཡིད་འོང་དྲི་ལྡན་ཆུ་ལ་ལང་ཚོ་མ་རྣམས་རོལ་སྒེག་ཁྲུས་ནི་བྱེད་བའི་དྲི་ལྡང་ཞིང་༎ ཨཽཏཔལ་གེ་སར་ལྡན་པའི་དྲི་རྣམས་ཀྱིས་བསྒོས་རླུང་གི་སྐྱེད་ཚལ་ག-ཡོ་བར་བྱེད་པ་ཡོད་༎
GK19kmeghdpu:66	 apy anyasmiñ jaladhara mahākālam āsādya kāle sthātavyaṃ te nayanaviṣayaṃ yāvad atyeti bhānuḥ /	T12D4302:344b-3	ཀབ༹་ཡེ་ཆུ་འཛིན་ནག་པོ་ཆེན་པོའི་གནས་སུ་བགྲོད་ནས་ཉིན་ཞག་གཞན་པའི་དུས་ལ་ཡང་༎ ཉིན་མོར་བྱེད་པ་འདྲེན་བྱེད་ཡུལ་དུ་འོངས་པར་གྱུར་གྱི་བར་དུ་ཁྱོད་ནི་གནས་པར་མཛོད་༎
GK19kmeghdpu:67	 kurvan saṃdhyābalipaṭahatāṃ śūlinaḥ ślāghanīyām āmandrāṇāṃ phalam avikalaṃ lapsyase garjitānām // KMgD_34 //	T12D4302:344b-5	རྩེ་གསུམ་ཅན་ལ་ཐུན་མཚམས་ལ་ནི་གཏོར་མ་རྔ་ཆེན་བསྒྲགས་ཤིང་བསྟོད་དབྱངས་བྱེད་པ་བཞིན་༎ ཁྱོད་ཀྱིས་འབྲུག་དབྱངས་བསྒྲགས་ཚེ་མ་ཚང་མེད་པའི་འབྲས་བུ་ཐོབ་པས་ཀུན་གྱི་དོན་ཡང་བྱེད་༎
GK19kmeghdpu:68	 pādanyāsakvaṇitaraśanās tatra līlāvadhūtai ratnacchāyāracitavalibhiś cāmaraiḥ klāntahastāḥ /	T12D4302:344b-7	དེ་ནས་རྐང་པ་བཀོད་པར་གྱུར་ཚེ་འོག་ཕག་དག་ལས་སིལ་སིལ་སྙན་པའི་སྒྲ་འབྱུང་ཞིང་༎
