src_segmentnr	src_original	tgt_segmentnr	tgt_original
GK19kmeghvpu:108	 tatra vyaktaṃ dṛṣadi caraṇanyāsam ardhendumauleḥ śaśvat siddhair upahṛtabaliṃ bhaktinamraḥ parīyāḥ /  yasmin dṛṣṭe karaṇavigamād ūrdhvam uddhūtapāpāḥ kalpante 'sya sthiragaṇapadaprāptaye śraddadhānāḥ // KMdV_55 //	T12D4302:346a-17	དེར་ནི་ཆེ་ཞིང་གསལ་བའི་རྡོལ་གཙུག་ན་ཟླ་ཕྱེད་འཛིན་པའི་རྐང་བཀོད་རྗེས་ལ་ནི་༎ རྟག་ཏུ་གྲུབ་པ་རྣམས་ཀྱིས་གཏོར་མ་མཆོད་ཀྱིས་གུས་པས་ཕྱག་དང་བསྐོར་བ་མཛོད་༎ གང་ཞིག་མཐོང་ན་བྱེད་པས་བྱས་པའི་སྡིག་པ་རྣམས་ནི་ཤིན་ཏུ་རིང་པོར་འདོར་བྱེད་ཅིང་༎ གུས་པ་འཛིན་པ་རྣམས་ནི་དེ་ཡི་འཁོར་དུ་གནས་པ་ཐོབ་བྱེད་བརྟན་པ་ཐོབ་པར་འགྱུར་༎
GK19kmeghvpu:110	 śabdāyante madhuram anilaiḥ kīcakāḥ pūryamāṇāḥ saṃraktābhis tripuravijayo gīyate kiṃnarībhiḥ /	T12D4302:346a-21	དྲི་ཞིམ་རྣམས་ཀྱིས་ཁེངས་པར་གྱུར་པའི་ཁང་པ་ནང་ནས་སྙན་པའི་ཡིད་འོང་སྒྲ་འབྱུང་ཞིང་༎ མིའམ་ཅི་མོ་རྣམས་ཀྱིས་གྲོང་ཁྱེར་གསུམ་རྒྱལ་འགྱུར་ལས་ཡང་དག་དགའ་བས་གླུ་དབྱངས་སྒྲོགས་༎
GK19kmeghvpu:111	 nirhrādī te muraja iva cet kandarāsu dhvaniḥ syāt saṃgītārtho nanu paśupates tatra bhāvī samastaḥ // KMdV_56 //	T12D4302:346a-23	རྡ་ཟླུམ་སྙན་པའི་སྒྲ་བཞིན་གལ་ཏེ་ཁྱོད་ཀྱིས་རྡོ་ཡི་གཙུག་ལག་ཁང་དེར་སྒྲ་སྙན་ནི་༎ བསྒྲགས་པར་གྱུར་ན་ངེས་པར་ཕྱུགས་བདག་དྲུང་དུ་གསུམ་འདུས་དབྱངས་སྙན་དོན་གྱི་ཚོགས་པ་འབྱུང་༎
GK19kmeghvpu:112	 prāleyādrer upataṭam atikramya tāṃs tān viśeṣān haṃsadvāraṃ bhṛgupatiyaśovartma yat krauñcarandhram /  tenodīcīṃ diśam abhisares tiryagāyāmaśobhī śyāmaḥ pādo baliniyamanābhyudyatasyeva viṣṇoḥ // KMdV_57 //	T12D4302:346b-0	གངས་ཀྱི་རིལ་ཉེ་བའི་ཐང་ལ་༄༣༤༦བ་རྐང་པ་བསྐྱོད་ཚེ་དེ་དང་དེ་ཡི་ཁྱད་པར་ལ་༎ ཀྲོཨོཉཙའི་རི་ཡི་ལམ་ལ་རབ་གྲགས་བྷྲི་གུའི་བདག་པོའི་མདའ་ཕུག་དང་པའི་སྒོ་ཅན་ཡོད་༎ དེ་ནས་ནོར་སྦྱིན་ཕྱོགས་སུ་ཁྱོད་ནི་རྗེས་སུ་འགྲོ་ཚོ་འཁྱོག་པོར་འགྲོ་བའི་མཛེས་པ་ནི་༎ སྟོབས་ལྡན་སླུ་བའི་ཆེད་དུ་ཁྱབ་འཇུགས་འཇལ་རྐང་པ་སྔོ་བསངས་ཡང་དག་བཀོད་པ་བཞིན་༎
GK19kmeghvpu:114	 gatvā cordhvaṃ daśamukhabhujocchvāsitaprasthasaṃdheḥ kailāsasya tridaśavanitādarpaṇasyātithiḥ syāḥ /	T12D4302:346b-4	མགྲིན་བཅུའི་ལག་པས་བསྐྱོད་བྱ་རི་ངོས་ཡངས་པ་དང་ལྡན་ཤེལ་གྱི་ཀེཨེ་ལ་ཤ་ཡི་རི་༎ སྐབས་གསུམ་མཛེས་མའི་གདོང་གི་མེ་ལོང་བསྟན་བྱའི་སྟེང་དུའང་སོང་སྟེ་ཅུང་ཟད་གནས་པར་བྱ་༎
GK19kmeghvpu:115	 śṛṅgocchrāyaiḥ kumudaviśadair yo vitatya sthitaḥ khaṃ rāśībhūtaḥ pratiniśam iva tryambakasyāṭṭahāsaḥ // KMdV_58 //  utpaśyāmi tvayi taṭagate snigdhabhinnāñjanābhe sadyaḥkṛttadviradadaśanacchedagaurasya tasya /  līlām adreḥ stimitanayanaprekṣaṇīyāṃ bhavitrīm aṃsanyaste sati halabhṛto mecake vāsasīva // KMdV_59 //	T12D4302:346b-6	གང་གི་རྩེ་མོ་ཤིན་ཏུ་མཐོ་བ་ཀུ་མུ་ཏ་ལྟར་མཁའ་ལ་ཁྱབ་བར་གནས་པ་ནི་༎ མིག་གསུམ་པ་ཡིས་རབ་ཏུ་བརྒད་པ་ཕྱོགས་བཅུ་དག་ནས་གཅིག་ཏུ་སྤུངས་པར་གྱུར་པ་བཞིན་༎ དེ་ཡི་རི་ངོས་དག་ལ་ཁྱོད་ནི་འགྲོ་ཚེ་སྣུམ་པའི་སྨན་མཆོག་དག་དང་མཚུངས་པ་དང་༎ དེ་ནི་གཉིས་འཐུང་སོ་ནི་འཕྲལ་ལ་བཅད་པར་བྱས་པ་ལྟ་བུར་དཀར་ཞིང་མཛེས་པ་དེ་༎ མཛེས་པའི་རི་བོ་ལ་ནི་ག-ཡོ་བ་མེད་བའི་མིག་གིས་བལྟ་བྱ་ཉིད་དུ་འགྱུར་བ་དང་༎ སྟོབས་ལྡན་དཀར་བའི་དཔུང་པ་དག་ལ་གོས་སྔོན་བཀོད་པར་གྱུར་བཞིན་འབྱུང་བ་བདག་གིས་ཤེས་༎
GK19kmeghvpu:118	 hitvā nīlaṃ bhujagavalayaṃ śambhunā dattahastā krīḍāśaile yadi ca viharet pādacāreṇa gaurī /	T12D4302:346b-10	དེར་ནི་བདེ་འབྱུང་སྦྲུལ་གྱི་གདུ་བུ་དོར་ནས་གོཨོ་རའིའི་ལག་པ་དག་ལ་འཛིན་བྱེད་ཅིང་༎ གལ་ཏེ་ཡང་ནི་རོལ་རྩེད་ཆེད་དུ་ཞབས་ཀྱིས་འགྲོ་བས་རི་ལ་དེ་དག་དལ་འགྲོ་ན་༎
GK19kmeghvpu:119	 bhaṅgībhaktyā viracitavapuḥ stambhitāntarjalo 'syāḥ sopānatvaṃ kuru sukhapadasparśam ārohaṇeṣu // KMdV_60 //	T12D4302:346b-12	ཁྱོད་བགྲོད་ལུས་ནི་འཁྱོག་པོར་འགྲོ་ཞིང་ནང་ན་གནས་པའི་ཆུ་ཆེན་དག་ནི་སྤང་བྱ་ཞིང་༎ བཀབ་པར་བྱས་ནས་སྟེང་དུ་འགྲོ་བ་རྣམས་ལ་རྐང་བའི་བདེ་བ་རེག་པར་བྱ་བ་མཛོད་༎
GK19kmeghvpu:120	 tatrāvaśyaṃ janitasalilodgāram antaḥpraveśān neṣyanti tvāṃ surayuvatayo yantradhārāgṛhatvam /	T12D4302:346b-14	རིགས་གནས་དེར་ནི་ཁྱོད་ཀྱིས་ཆུ་རྣམས་སྐྱུགས་པར་བྱས་པས་ངེས་པར་ནང་ན་མེད་བ་ན་༎ ལྷ་ཡིན་ཆུང་རྣམས་ཀྱིས་ཁྱོད་ནི་འཁྲུལ་འཁོར་གྱིས་བཟུང་ཁང་བཟངས་ནང་དུ་འཁྱེར་པར་བྱེད་༎
GK19kmeghvpu:121	 tābhyo mokṣas tava yadi sakhe gharmalabdhasya na syāt krīḍālolāḥ śravaṇaparuṣair garjitair bhāyayes tāḥ // KMdV_61 //	T12D4302:346b-16	ཀབ༹་ཡེ་གྲོགས་བཟང་ཚ་བས་གདུངས་པ་དེ་རྣམས་ཆེད་དུ་གལ་ཏེ་ཁྱོད་ནི་མི་གཏོང་ན་༎ རོལ་སྒེག་ག-ཡོ་བའི་མཛེས་མ་དེ་རྣམས་རྣ་བར་རྩུབ་པའི་སྒྲ་ཆེན་བསྒྲགས་བས་འཇིགས་པར་བྱ་༎
GK19kmeghvpu:122	 hemāmbhojaprasavi salilaṃ mānasasyādadānaḥ kurvan kāmāt kṣaṇamukhapaṭaprītim airāvaṇasya /  dhunvan vātaiḥ sajalapṛṣataiḥ kalpavṛkṣāṃśukāni cchāyābhinnaḥ sphaṭikaviśadaṃ nirviśeḥ paravataṃ tam // KMdV_62 //	T12D4302:346b-18	ཆུ་ཐིགས་དག་གིས་བྲན་པ་དང་ལྡན་དྲི་བཞོན་གྱིས་བསྐྱོད་དཔག་བསམ་ཤིང་ལ་ག-ཡོ་བཞིན་དུ་༎ ཁྱོད་ཀྱི་གྲིབ་འོད་ཤེལ་ལྟར་དཀར་བའི་གོས་ཀྱིས་རི་དབང་དེ་ནི་ཡོངས་སུ་ག-ཡོགས་བྱ་ཞིང་༎ ཡིད་འོང་ཆུ་བོ་བཞི་ཡི་རྒྱུན་ནི་གསེར་གྱི་ཆུ་སྐྱེས་གསར་པ་ལྟར་དེའང་འཐུང་བ་དང་༎ ས་སྲུང་བུ་ཡི་གདོང་པའི་གོས་ནི་ཅི་འདོད་སྤྱད་ཅིང་དགའ་བའང་སྐད་ཅིག་བྱ་བར་མཛོད་༎
GK19kmeghvpu:124	 tasyotsaṅge praṇayina iva srastagaṅgādugūlāṃ na tvaṃ dṛṣṭvā na punar alakāṃ jñāsyase kāmacārin /	T12D4302:347a-0	ཀབ༹་ཡེ་འདོད་བཞིན་རྒྱུ་བྱེད་ཁྱོད་ནི་དེས་༄༣༤༧ཨ་༌་༎ ལས་རྒལ་ཚེ་ལྕང་ལོ་ལྡན་མ་ཤེས་པར་འགྱུར་༎ སླར་ཡང་རི་དེ་ག-ཡོ་ལྡན་གངགའའི་ཆུ་གོས་ལྡན་མའི་བདག་པོ་བཞིན་དུ་མི་མཐོང་མིན་།
GK19kmeghvpu:125	 yā vaḥ kāle vahati salilodgāram uccairvimānā muktājālagrathitam alakaṃ kāminīvābhravṛndam // KMdV_63 //	T12D4302:347a-3	མཐོང་བའི་གཞལ་མེད་ཁང་སྟེང་ཆར་སྤྲིན་ཆེ་ལས་ཁྱོད་ཀྱི་ཆུ་བྱས་བྱས་དུས་སུ་ནི་༎ གང་ཞིག་འདོད་ལྡན་མ་ནི་ལེན་བུ་མུ་ཏིག་དྲ་བས་བསྒྲིགས་པའི་ཕྲེང་བ་ལྡན་པ་བཞིན་༎ ཁྱོད་ལ་གློག་འོད་ལྡན་བཞིན་སྒེག་པའི་མཛེས་མ་དང་ལྡན་དབང་པོའི་གཞུ་བཞིན་བཀྲ་བར་ལྡན་༎
GK19kmeghvpu:126	 vidyutvantaṃ lalitavanitāḥ sendracāpaṃ sacitrāḥ saṃgītāya prahatamurajāḥ snigdhagambhīraghoṣam /	T12D4302:347a-6	སྙན་པའི་དབྱངས་ནི་ཟབ་པ་བཞིན་དུ་གླུ་དབྱངས་དག་དང་རོལ་མོའི་དབྱངས་སྙན་རྣམས་དང་ལྡན་༎
GK19kmeghvpu:127	 antastoyaṃ maṇimayabhuvas tuṅgam abhraṃlihāgrāḥ prāsādās tvāṃ tulayitum alaṃ yatra tais tair viśeṣaiḥ // KMdV_64 //	T12D4302:347a-7	ཆུ་ཡི་སྙིང་པོ་ཅན་བཞིན་ས་གཞི་ནོར་བུའི་རང་བཞིན་མཐོ་བཞིན་རྩེ་མོ་མཁའ་ལ་རེག་། གང་དུ་ཁྱད་པར་དེ་རྣམས་ཀྱིས་ནི་ཁྱོད་དང་ཁང་བཟངས་མཚུངས་པའི་ཆེད་དུ་ནི་ནོར་བུར་ལྡན་༎
GK19kmeghvpu:128	 haste līlākamalam alakaṃ bālakundānuviddhaṃ nītā rodhraprasavarajasā pāṇḍutām ānanaśrīḥ /	T12D4302:347a-9	གང་དུ་ན་ཆུང་རྣམས་ནི་ལག་པད་མཛེས་ཤིང་ལེན་བུའི་ཀུན་ད་གཞོན་ནུའི་སྐྲ་ནི་འཆིང་༎ གདོང་གི་ཆུ་སྐྱེས་འཛུམ་ཞིང་དཀར་བའི་གེ་སར་དབལ་ནི་གསར་པ་དག་གིས་མཛེས་བྱས་ཤིང་༎ གཙུག་ཕུད་ཀུ་རུ་བ་ཀའི་མེ་ཏོག་ཞགས་པས་བཅིངས་པ་མཛེས་ཤིང་རྣ་བར་ཨཽཏཔལ་ཅན་༎
GK19kmeghvpu:144	 vāpī cāsmin marakataśilābaddhasopānamārgā haimaiḥ syūtā kamalamukulaiḥ snigdhavaiḍūryanālaiḥ /	T12D4302:347b-16	བཀོང་མ་བཟང་མོའི་ཆུ་ནི་མར་ཀ་ཏའི་རྡོ་ཡི་ཕྲིང་བ་བསྒྲིགས་པའི་ལམ་སྐས་ཅན་༎ འདི་ནས་མཛེས་པའི་གསེར་གྱི་པདམ་རྒྱས་པ་རིན་ཆེན་རྩ་ལྡན་རྣམས་ཀྱིས་ཁྱབ་པ་སྟེ་༎
GK19kmeghvpu:145	 yasyās toye kṛtavasatayo mānasaṃ saṃnikṛṣṭaṃ na dhyāsyanti vyapagataśucas tvām api prekṣya haṃsāḥ // KMdV_73 //	T12D4302:347b-18	གདུང་བ་དང་བྲལ་ངང་བའི་ཚོགས་རྣམས་དག་ནི་གངགའའི་ཆུ་ལ་གནས་པར་བྱས་པའི་ཚེ་༎ ཁྱོད་ཉིད་ཡང་དག་མཐོང་བར་གྱུར་ཀྱང་ཉེ་བར་གནས་པའི་ཡིད་འོང་མཚོ་ལས་འགྲོ་མི་འགྱུར་༎
GK19kmeghvpu:146	 yasyās tīre nicitaśikharaḥ peśalair indranīlaiḥ krīḍāśailaḥ kanakakadalīveṣṭanaprekṣaṇīyaḥ /	T12D4302:347b-20	ཀབ༹་ཡེ་གྲོགས་བཟང་ཁྱོད་ནི་གློག་གི་དག་འམ་ག-ཡོ་བཞིན་ཉེ་བར་མཐོང་བར་གྱུར་པ་ན་༎ མཚོ་དེའི་དོགས་ན་མཛེས་པའི་རི་བོ་ཡིད་འོང་མཆོག་གི་ཨཻནདྲ་ནའི་ལ་རྣམས་ཀྱིས་ནི་༎
GK19kmeghvpu:147	 madgehinyāḥ priya iti sakhe cetasā kātareṇa prekṣyopāntasphuritataḍitaṃ tvāṃ tam eva smarāmi // KMdV_74 //	T12D4302:347b-22	རྩེ་མོ་མཛེས་པར་བྱས་པར་གསར་གྱི་བསྐོར་བ་རྣམས་ཀྱིས་བསྐོར་བ་ཁྱོད་ཀྱིས་བལྟ་བྱ་བ་། བདག་གི་དགའ་མ་དགའ་བྱེད་༄༣༤༨ཨ་༌་༎ དང་བཅས་དེ་ཉིད་སེམས་གདུངས་བདག་ནི་ཤིན་ཏུ་དྲན་པར་གྱུར་༎
GK19kmeghvpu:148	 raktāśokaś calakisalayaḥ kesaraś cātra kāntaḥ pratyāsannau kuravakavṛter mādhavīmaṇḍapasya /	T12D4302:348a-2	དེ་ལ་ཀུ་རུ་བ་ཀའི་ཤིང་གིས་བསྐོར་བའི་ཡལ་གའི་ཁང་བཟངས་དང་ལྡན་ཉེ་བ་ན་༎ མྱ་ངན་མེད་ཤིང་དམར་དང་ཀེ་ས་ར་ཡི་ཤིང་ཆེན་ཡལ་འདབ་ག-ཡོ་བ་མཛེས་པ་ཡོད་༎
GK19kmeghvpu:149	 ekaḥ sakhyās tava saha mayā vāmapādābhilāṣī kāṅkṣaty anyo vadanamadirāṃ dohadacchadmanāsyāḥ // KMdV_75 //	T12D4302:348a-4	གཅིག་ལ་ཁྱོད་ཀྱི་གྲོགས་སུ་གྱུར་བའི་དགའ་མ་བདག་དང་བཅས་པའི་ག-ཡོན་པས་བསྒྲུན་འདོད་ཅིང་༎ གཞན་ལ་གདོང་གི་ཆང་འཐུངས་མེ་ཏོག་འབྱུང་བའི་དོན་དུ་དགའ་མ་དེ་ནི་བདག་འདོད་གྱུར་༎
GK19kmeghvpu:150	 tanmadhye ca sphaṭikaphalakā kāñcanī vāsayaṣṭir mūle naddhā maṇibhir anatiprauḍhavaṃśaprakāśaiḥ /	T12D4302:348a-6	དེ་ཡི་དབུས་ན་རབ་དཀར་ཤེལ་གྱི་གཞལ་གསེར་གྱི་སྡོང་པོ་ཆེ་ཞིང་མཐོ་བར་གནས་༎ རྩ་བ་རིན་ཆེན་ཕྲེང་བས་བཅིངས་པ་རྡོ་རྗེ་ཕ་ལམ་ཆེ་བ་མིན་པ་འོད་འཕྲོ་བ་༎
GK19kmeghvpu:151	 tālaiḥ śiñjadvalayasubhagair nartitaḥ kāntayā me yām adhyāste divasavigame nīlakaṇṭhaḥ suhṛd vaḥ // KMdV_76 //  ebhiḥ sādho hṛdayanihitair lakṣaṇair lakṣaṇīyaṃ dvāropānte likhitavapuṣau śaṅkhapadmau ca dṛṣṭvā /  kṣāmacchāyaṃ bhavanam adhunā madviyogena nūnaṃ sūryāpāye na khalu kamalaṃ puṣyati svām abhikhyām // KMdV_77 //	T12D4302:348a-8	གང་ལ་ཁྱོད་ཀྱི་གྲོགས་བཟང་མགྲིན་སྔོན་གནས་ནས་ཉིན་ཕྱེད་སོང་ཚེ་རོལ་སྒེག་གར་བྱེད་ཅིང་༎ བདག་གི་མཛེས་མ་རིན་ཆེན་གདུ་བུ་འཐབ་པའི་དབྱངས་སྙན་སྐལ་བཟང་མཆོག་ཏུ་མཛེས་པ་ཡོད་༎ དེ་རྣམས་ཀྱིས་ནི་ལེགས་པར་མཚན་པ་ཀབ༹་ཡེ་ལེགས་པའི་ཐུགས་འཛིན་ཁྱོད་ཀྱིས་བལྟ་བར་བྱ་༎ སྒོ་ཡི་མཐའ་དང་ཉེ་བ་དག་ན་དུང་དང་པདམའི་གཟུགས་བྲིས་མཐོང་བར་བྱས་པ་ན་༎ ད་ལྟ་བདག་དང་བྲལ་བར་གྱུར་པས་ངེས་པར་མཛེས་པ་དམན་པ་ཉིད་དུ་གནས་པར་ངེས་༎
GK19kmeghvpu:154	 gatvā sadyaḥ kalabhatanutāṃ śīghrasaṃpātahetoḥ krīḍāśaile prathamakathite ramyasānau niṣaṇṇaḥ /	T12D4302:348a-14	མཛེས་མ་དེ་ནི་ཡོངས་སུ་བསྐྱངས་ཆེད་མྱུར་དུ་གཤེགས་ནས་གླང་ཕྲུག་ལུས་བཞིན་ཆུང་བ་ཡིས་༎ མཛེས་པའི་རི་བོ་དེ་ཡི་ངོས་ལ་གནས་ནས་དང་པོར་ལེགས་བཤད་སྙན་པའི་གསུང་གླེང་མཛོད་༎
GK19kmeghvpu:38	 tasyās tiktair vanagajamadair vāsitaṃ vāntavṛṣṭir jambūṣaṇḍapratihatarayaṃ toyam ādāya gaccheḥ /	T12D4302:343a-13	ཁྱོད་ཀྱིས་ཐོག་མར་ཆར་པ་སྒྱུག་བྱ་དེ་ཡི་ཆུ་ནི་འཐུངས་ནས་བགྲོད་པར་བྱ་སྟེ་ཕྱིན་ནས་ནི་༎ ནགས་ཀྱི་གླང་པོ་མྱོས་པའི་ཏིག་ཏའི་རོ་དང་འཛམ་བུའི་ཤིང་གི་ཆུ་དེའང་མྱུར་དུ་འགེངས་༎
GK19kmeghvpu:39	 antaḥsāraṃ ghana tulayituṃ nānilaḥ śakṣyati tvāṃ riktaḥ sarvo bhavati hi laghuḥ pūrṇatā gauravāya // KMdV_20 //	T12D4302:343a-15	ཀབ༹་ཡེ་སྦྲིན་སྟུག་ཁྱོད་ནི་ནང་གི་སྙིང་པོ་ལྡན་ན་དྲི་བཞོན་དག་གིས་ག-ཡོ་མི་ནུས་༎ གང་ཕྱིར་ཐམས་ཅད་སྟོང་ན་ཡང་བར་འགྱུར་ཞིང་ཡོངས་སུ་གང་ན་ཀུན་ཀྱང་ལྗི་བ་ཉིད་༎
GK19kmeghvpu:40	 nīpaṃ dṛṣṭvā haritakapiśaṃ kesarair ardharūḍhair āvirbhūtaprathamamukulāḥ kandalīś cānukaccham /	T12D4302:343a-17	དང་པོར་ཀནདལི་ཡི་མེ་ཏོག་ཁ་འབུས་རྣམས་ནི་ཤུན་པས་བསྒྲིབས་པ་བྱུང་བ་དང༎ འདབ་མ་ལྗང་ཞིང་གེ་སར་དཀར་སེར་ཕྱེ་ལྡན་བརྟན་པ་རྣམས་ཀྱི་ཆུ་སྐྱེས་མེ་ཏོག་མཐོང་ནས་ཀྱང་༎
GK19kmeghvpu:41	 dagdhāraṇyeṣv adhikasurabhiṃ gandham āghrāya corvyāḥ sāraṅgās te jalalavamucaḥ sūcayiṣyanti mārgam // KMdV_21 //	T12D4302:343a-19	ཆུ་འཛིན་དལ་བུས་ཆར་བསྐྲུན་ཁྱོད་ལ་སའ་རིགས་རྣམས་ནི་སྟོན་པར་བྱེད་པར་འགྱུར་༎ ཙའུ་ཏ་ཀ་རྣམས་ཆུ་ཡི་ཐིགས་པ་བཟུང་ནས་དགའ་བས་འཐུང་ལ་ལྟ་བར་བྱེད་བཞིན་དང་༎ ཆུ་སྒྲོགས་རྣམས་ནི་ཕྲིང་བར་བསྒྲིགས་རྣམས་ཡོངས་སུ་བསྒྲེང་ཞིང་ཅི་ཞེས་ངེས་པར་ལྟ་བཞིན་དང་༎ མཆོག་ཏུ་འདར་བྱས་དགའ་བས་དགའ་མ་ལ་ནི་༄༣༤༣བ་དམ་དུ་འཁྱུད་པ་རྣམས་ནི་བྱེད་པ་ཡིན་༎ ཀ་ཀུ་བྷ་ཡི་དྲི་ལྡན་རི་བོ་རི་བོ་རྣམས་ལ་ཡུན་རིང་ཐོགས་པར་བདག་གིས་ཤེས་༎ གཙུག་པུད་ཅན་གྱི་འདྲེན་བྱེད་ཆུ་དང་བཅས་པས་ལེགས་པར་འོངས་སམ་བྱས་ནས་ཡུན་རིང་གནས་པར་འདོད་༎
GK19kmeghvpu:42	 utpaśyāmi drutam api sakhe matpriyārthaṃ yiyāsoḥ kālakṣepaṃ kakubhasurabhau parvate parvate te /  śuklāpāṅgaiḥ sanayanajalaiḥ svāgatīkṛtya kekāḥ pratyudyātaḥ katham api bhavān gantum āśu vyavasyet // KMdV_22 //	T12D4302:343b-4	དེ་སླད་ཁྱོད་ནི་ཤིན་ཏུ་ཤིན་ཏུ་མྱུར་བ་འགྲོ་བར་འགྱུར་བ་དག་ཀྱང་ཇི་ལྟར་ཡིན་༎ ཁྱོད་འོངས་ཚེ་ན་ངང་པ་རྣམས་ནི་དེ་ཉིད་ཅུང་ཟད་གནས་ནས་འགྲོ་ཞིང་འབྲས་བུ་ནི་༎ ཡོངས་སུ་སྨིན་པ་ལྗང་སྔོན་དང་ལྡན་འཛམ་བུའི་ནགས་ཀྱིས་བསྐོར་དབུས་དཀར་པོའི་འོད་ལྡན་ཆེ་བ་ཡི་༎
GK19kmeghvpu:44	 pāṇḍucchāyopavanavṛtayaḥ ketakaiḥ sūcibhinnair nīḍārambhair gṛhabalibhujām ākulagrāmacaityāḥ /	T12D4302:343b-7	ནགས་ཀྱི་འཁྲི་ཤིང་ཀེ་ཏའི་ཆུ་སྐྱེས་གེ་སར་གསལ་བར་རྒྱས་ཤིང་གྲོང་དང་མཆོད་རྟེན་གྱིས་༎ བསྐོར་བའི་ཁང་པར་གཏོར་ལེན་ཚང་སྐྱེད་རྩོམ་པའི་གྲོང་ཁྱེར་ཏམ་ཤ་ཞེས་པས་མཆོད་པར་འགྱུར་༎
GK19kmeghvpu:45	 tvayy āsanne phalapariṇatiśyāmajambūvanāntāḥ saṃpatsyante katipayadinasthāyihaṃsā daśārṇāḥ // KMdV_23 //  teṣāṃ dikṣu prathitavidiśālakṣaṇāṃ rājadhānīṃ gatvā sadyaḥ phalam avikalaṃ kāmukatvasya labdhā /	T12D4302:343b-9	དེ་ཡི་བྱང་ཕྱོགས་གཞི་ལ་བི་དི་ཤ་ཞེས་མཆོད་ཆ་རྒྱལ་པོའི་ཁབ་ཏུ་མྱུར་སོང་ནས་༎ དེར་ནི་ཁྱོད་ཀྱིས་ཤིན་ཏུ་ཆེ་བའི་འབྲས་བུ་ཐོབ་མཆོག་གོ་འཕང་འཕྲལ་ལ་ཐོབ་འགྱུར་ཞིང་༎
GK19kmeghvpu:47	 tīropāntastanitasubhagaṃ pāsyasi svādu yat tat sabhrūbhaṅgaṃ mukham iva payo vetravatyāś calormi // KMdV_24 //	T12D4302:343b-11	ཆེ་བའི་ཁ་ཞེང་དང་ལྡན་མཐའ་ནས་ལྷུང་ལྷུང་སྐད་སྙན་སྒྲོགས་ཤིང་དང་ཞིང་བསིལ་ལྡན་པ་༎ ག-ཡོ་བའི་རླབས་ཕྲེང་གདོང་ཁ་སྨིན་མ་ག-ཡོ་བཞིན་པ་འདྲའི་མཚོ་དེའང་སྐལ་བཟང་ཁྱོད་འཐུང་འགྱུར་༎
GK19kmeghvpu:48	 nīcairākhyaṃ girim adhivases tatra viśrāmahetos tvatsamparkāt pulakitam iva prauḍhapuṣpaiḥ kadambaiḥ /	T12D4302:343b-13	གང་ཞིག་ནི་ཙ་ཞེས་གྲགས་རི་བོར་ཁྱོད་འོངས་ཐོབ་ལས་དེར་ནི་ངལ་བསོའི་ཆེད་དུ་གནས་༎ ཀ་དམ་པ་ཡི་མེ་ཏོག་དགའ་བས་སྤུ་ལོང་རྒྱས་ཤིང་གེ་སར་འཛུམ་པར་བྱེད་པ་བཞིན་༎
GK19kmeghvpu:49	 yaḥ paṇyastrīratiparimalodgāribhir nāgarāṇām uddāmāni prathayati śilāveśmabhir yauvanāni // KMdV_25 //  viśrāntaḥ san vraja vananadītīrajātāni siñcann udyānānāṃ navajalakaṇair yūthikājālakāni /	T12D4302:343b-15	གྲོང་ཁྱེར་རྣམས་ནི་སྨན་འཚོང་མ་རྣམས་དགའ་བར་བྱེད་པའི་དྲི་བཟངས་དག་གིས་གང་བ་རྣམས་༎ རྡོ་ཡི་ཕྲག་ཕྲུག་རྣམས་ཀྱི་མཆོག་ཏུ་མཛེས་བའི་ལང་ཚོམ་རྣམས་སྨྲ་རུ་འཇུག་པ་བཞིན་༎ ངལ་སོས་གྱུར་ན་བགྲོང་བྱ་གསར་སྐྱེས་རྣམས་ཀྱི་མེ་ཏོག་གསར་པའི་དྲ་བ་མཛེས་པ་རྣམས་༎ ཆུ་བོ་ཆུ་ངོགས་སྐྱེས་པ་རྣམས་ནི་ཆུ་ཐིགས་རྣམས་ཀྱིས་བྲན་པ་འཕྲལ་དུ་འོངས་འགྱུར་ཞིང་༎
GK19kmeghvpu:51	 gaṇḍasvedāpanayanarujāklāntakarṇotpalānāṃ chāyādānāt kṣaṇaparicitaḥ puṣpalāvīmukhānām // KMdV_26 //	T12D4302:343b-19	ཆུ་སྐྱེས་ཐོག་མའི་གདོང་གི་འགྲམ་པའི་རྡུལ་ཐིགས་སེར་ལ་རྣ་བའི་ཨཽཏཔལ་ངལ་བ་དང་༎ རྙིངས་གྱུར་ལ་ནི་ཉིད་ཀྱིས་སྐད་ཅིག་བདེ་བའི་གྲིབ་བསིལ་ཡོངས་སུ་གནང་བར་མཛོད་ཅིག་ཀྱེ་༎
GK19kmeghvpu:52	 vakraḥ panthā yad api bhavataḥ prasthitasyottarāśāṃ saudhotsaṅgapraṇayavimukho mā sma bhūr ujjayinyāḥ /	T12D4302:343b-20	ཡང་ནི་བྱང་གི་ཕྱོགས་སུ་བགྲོད་ཅིང་གང་ཞིག་ཁྱེད་ནི་འཁྱོག་པོའི་ལམ་ལ་ཞུགས་པའི་ཚེ་༎ གྲོང་ཁྱེར་ཨཽཛཛ་ཡ་ནའི་རྒྱལ་པོའི་ཕོ་བྲང་ནང་དུ་ཕྱིར་ཕྱོགས་མིན་པར་གནས་པར་མཛོད་༎
GK19kmeghvpu:53	 vidyuddāmasphuritacakitais tatra paurāṅganānāṃ lolāpāṅgair yadi na ramase locanair vañcito 'si // KMdV_27 //  vīcikṣobhastanitavihagaśreṇikāñcīguṇāyāḥ saṃsarpantyāḥ skhalitasubhagaṃ darśitāvartanābheḥ /	T12D4302:344a-0	དེ་ན་གྲོང་གི་དགའ་མ་རྣམས་ཀྱི་རོལ་སྒེག་ཟུར་མིག་གློག་གི་༄༣༤༤ཨ་༌་༎ ཐག་པ་ག-ཡོ་བ་ནི་༎ སྐྱོང་བྱེད་མིག་གིས་གལ་ཏེ་ཁྱོད་ནི་མ་མཐོང་འབྲས་བུ་མེད་ཅིང་བསླུས་པ་ཉིད་དུ་འང་འགྱུར་༎ རླབས་ཕྲེང་ག-ཡོ་ལྡན་སྙན་པར་སྒྲོགས་ཤིང་འདབ་ཆགས་ཕྲེང་བའི་རྐེད་རྒྱན་སྐ་རགས་སིལ་སིལ་ཅན་༎ དལ་གྱིས་དལ་གྱིས་འགྲོ་ཞིང་ལང་ལིང་མཛེས་པའི་སྐལ་བཟང་འཁོར་ལོའི་ལྟེ་བ་དང་ལྡན་པ་༎
GK19kmeghvpu:55	 nirvindhyāyāḥ pathi bhava rasābhyantaraḥ saṃnipatya strīṇām ādyaṃ praṇayavacanaṃ vibhramo hi priyeṣu // KMdV_28 //	T12D4302:344a-5	རོ་མཆོག་དང་ལྡན་ཆུ་བོའི་ན་ཆུང་བིར་བིནདྷ་ནི་ཁྱོད་ནི་ལམ་ན་མངོན་བཞུགས་ནས་༎ དགའ་མ་རྣམས་ཀྱིས་མཛའ་བོ་རྣམས་ལ་རོལ་སྒེག་ཐོག་མར་སྟོན་ཅིང་རྐེད་རྒྱན་འགྲོལ་འདྲ་མཐོའ་༎
GK19kmeghvpu:56	 veṇībhūtapratanusalilāṃ tām atītasya sindhuṃ pāṇḍucchāyāṃ taṭaruhatarubhraṃśibhir jīrṇaparṇaiḥ /	T12D4302:344a-7	དེ་རྒལ་སིནདྷུའི་ཆུ་ནི་ལེན་བུ་བཞིན་དུ་ལུས་ནི་རབ་ཏུ་ཕྲ་བར་གྱུར་པ་ཅན་༎ དགོས་སུ་གྱུར་པའི་ཤིང་ནི་རྙིངས་པའི་འདབ་མ་ལྷུང་བ་རྣམས་ཀྱིས་ཁྱབ་པར་བཀྲམ་པས་དཀར་༎
GK19kmeghvpu:57	 saubhāgyaṃ te subhaga virahāvasthayā vyañjayantīṃ kārśyaṃ yena tyajati vidhinā sa tvayaivopapādyaḥ // KMdV_29 //	T12D4302:344a-9	ཀབ༹་ཡེ་སྐལ་བཟང་ཁྱོད་དང་བྲལ་བར་གནས་པས་ལུས་ཀྱི་གནས་སྐབས་འདི་འདྲར་འགྱུར་༎ གང་གི་ཆུང་མ་སྤངས་ནས་ཆེ་བའི་གནས་སྐབས་མཛད་དམ་ཁྱོད་མཁྱེན་དེ་ནི་རྗོད་པར་བྱེད་༎
GK19kmeghvpu:58	 prāpyāvantīn udayanakathākovidagrāmavṛddhān pūrvoddiṣṭām anusara purīṃ śrīviśālāṃ viśālām /	T12D4302:344a-11	ཨཨ་ཝནཏའི་ཡུལ་ཐོག་ན་ཨཽ་ད་ཡ་ནའི་གཏམ་ནི་གྲོང་གི་རྒན་མོས་ཤེས་པ་ཡོད་༎ དེ་རྗེས་གྲོང་ཁྱེར་སྔར་བསྟན་ཁང་པ་ཡངས་ཤིང་དཔལ་དང་ཕུན་ཚོགས་ཆེ་ལྡན་ཡངས་པ་ཅན་༎
GK19kmeghvpu:59	 svalpībhūte sucaritaphale svargiṇāṃ gāṃ gatānāṃ śeṣaiḥ puṇyair hṛtam iva divaḥ kāntimat khaṇḍam ekam // KMdV_30 //	T12D4302:344a-13	འཛམ་གླིང་ས་གཞིར་མཐོ་རིས་མཛེས་ལྡན་དུམ་བུ་བསོད་ནམས་ལྷག་མ་རྣམས་ཀྱི་སྐབས་གསུམ་པའི་༎ ལེགས་བཤད་འབྲས་བུར་གྱུར་པ་ཉུང་ཤས་འགའ་ཞིག་དག་ནི་ཕྲོགས་ནས་འོངས་པར་གྱུར་པ་བཞིན་༎
GK19kmeghvpu:60	 dīrghīkurvan paṭu madakalaṃ kūjitaṃ sārasānāṃ pratyūṣeṣu sphuṭitakamalāmodamaitrīkaṣāyaḥ /	T12D4302:344a-15	གང་དུ་བཞད་རྣམས་མྱོས་པའི་གདངས་སྙན་ཆེ་བར་སྒྲོགས་ཤིང་ཡིད་འོང་སྒྲ་ནི་གསལ་བར་བྱེད་༎ ཉི་གཞོན་གྱིས་རྒྱས་ཆུ་སྐྱེས་དྲི་བཟངས་དགའ་སྐྱེད་བསྐ་བའི་རོ་ལྡན་ཡིད་དུ་འོང་གྱུར་ཅིང་༎
GK19kmeghvpu:61	 yatra strīṇāṃ harati surataglānim aṅgānukūlaḥ siprāvātaḥ priyatama iva prārthanācāṭukāraḥ // KMdV_31 //	T12D4302:344a-17	ཆུ་ཐིགས་ཀྱིས་བྲན་དྲི་བཞོན་བུད་མེད་ཆགས་གཟིར་གདུང་བ་ཕྲོག་བྱེད་ལུས་ཀྱི་རྗེས་མཐུན་པ་༎ བདག་བོ་མཆོག་ནི་འདོད་དོན་གཉེར་བར་བྱེད་ལ་སྙན་པར་སྒྲོགས་ཤིང་དགའ་བར་བྱེད་པ་བཞིན་༎
GK19kmeghvpu:62	 jālodgīrṇair upacitavapuḥ keśasaṃskāradhūmair bandhuprītyā bhavanaśikhibhir dattanṛttopahāraḥ /  harmyeṣv asyāḥ kusumasurabhiṣv adhvakhinnāntarātmā nītvā rātriṃ lalitavanitāpādarāgāṅkiteṣu // KMdV_32 //	T12D4302:344a-19	དེ་ཡི་ནོར་ལྡན་ཁང་པ་རྣམས་ན་ལེན་བུ་སྤོས་ཀྱིས་བདུགས་པའི་དྲི་བཟངས་དྲ་བ་ནས་༎ འཐོན་པས་ཁྱོད་ལུས་ཆེར་འགྱུར་ཁྱིམ་གྱི་གཅུག་པུད་ཅན་ནི་དགའ་བས་གཉེན་མཐོང་གར་གྱིས་ནི་༎ མཆོད་འབུལ་ཆུ་སྐྱེས་དྲི་བཟངས་ལྡན་པ་བུད་མེད་རོལ་སྒེག་ལྡན་པའི་རྐང་པའི་ཚོན་རྣམས་ཀྱིས་༎ མཚན་པ་རྣམས་ཀྱི་དབུས་སུ་དུབ་པར་གྱུར་པའི་རང་ཉིད་སྡུག་བསྔལ་བསལ་བར་བྱ་༎
GK19kmeghvpu:64	 bhartuḥ kaṇṭhacchavir iti gaṇaiḥ sādaraṃ dṛśyamāṇaḥ puṇyaṃ yāyās tribhuvanaguror dhāma caṇḍeśvarasya /	T12D4302:344a-23	ཡང་ནི་སྲིད་པ་གསུམ་གྱི་བླ་མ་དཔལ་མགྲིན་གནས་སུ་བསོད་ནམས་ལྡན་ཁྱོད་བགྲོད་པར་བྱ་༎ འཁོར་ཚོགས་ཆོས་ཀྱིས་༄༣༤༤བ་ཁྱབ་བདག་མགྲིན་འོད་མཚུངས་བཞིན་ཞེས་གུས་དང་བཅས་པས་ལྟ་བར་བྱེད་༎
GK19kmeghvpu:65	 dhūtodyānaṃ kuvalayarajogandhibhir gandhavatyās toyakrīḍāniratayuvatisnānatiktair marudbhiḥ // KMdV_33 //	T12D4302:344b-1	ཡིད་འོང་དྲི་ལྡན་ཆུ་ལ་ལང་ཚོ་མ་རྣམས་རོལ་སྒེག་ཁྲུས་ནི་བྱེད་བའི་དྲི་ལྡང་ཞིང་༎ ཨཽཏཔལ་གེ་སར་ལྡན་པའི་དྲི་རྣམས་ཀྱིས་བསྒོས་རླུང་གི་སྐྱེད་ཚལ་ག-ཡོ་བར་བྱེད་པ་ཡོད་༎
GK19kmeghvpu:66	 apy anyasmiñ jaladhara mahākālam āsādya kāle sthātavyaṃ te nayanaviṣayaṃ yāvad abhyeti bhānuḥ /	T12D4302:344b-3	ཀབ༹་ཡེ་ཆུ་འཛིན་ནག་པོ་ཆེན་པོའི་གནས་སུ་བགྲོད་ནས་ཉིན་ཞག་གཞན་པའི་དུས་ལ་ཡང་༎ ཉིན་མོར་བྱེད་པ་འདྲེན་བྱེད་ཡུལ་དུ་འོངས་པར་གྱུར་གྱི་བར་དུ་ཁྱོད་ནི་གནས་པར་མཛོད་༎
GK19kmeghvpu:67	 kurvan saṃdhyābalipaṭahatāṃ śūlinaḥ ślāghanīyām āmandrāṇāṃ phalam avikalaṃ lapsyase garjitānām // KMdV_34 //	T12D4302:344b-5	རྩེ་གསུམ་ཅན་ལ་ཐུན་མཚམས་ལ་ནི་གཏོར་མ་རྔ་ཆེན་བསྒྲགས་ཤིང་བསྟོད་དབྱངས་བྱེད་པ་བཞིན་༎ ཁྱོད་ཀྱིས་འབྲུག་དབྱངས་བསྒྲགས་ཚེ་མ་ཚང་མེད་པའི་འབྲས་བུ་ཐོབ་པས་ཀུན་གྱི་དོན་ཡང་བྱེད་༎
GK19kmeghvpu:68	 pādanyāsakvaṇitaraśanās tatra līlāvadhūtai ratnacchāyākhacitavalibhiś cāmaraiḥ klāntahastāḥ /	T12D4302:344b-7	དེ་ནས་རྐང་པ་བཀོད་པར་གྱུར་ཚེ་འོག་ཕག་དག་ལས་སིལ་སིལ་སྙན་པའི་སྒྲ་འབྱུང་ཞིང་༎ རོལ་སྒེག་ག-ཡོ་བའི་རིན་ཆེན་འོད་འཕྲོས་ལུས་མཛེས་རྔ་ཡབ་འཛིན་པས་ངལ་བའི་ལག་པ་ཅན་༎
GK19kmeghvpu:69	 veśyās tvatto nakhapadasukhān prāpya varṣāgrabindūn āmokṣyanti tvayi madhukaraśreṇidīrghān kaṭākṣān // KMdV_35 //  paścād uccairbhujataruvanaṃ maṇḍalenābhilīnaḥ sāṃdhyaṃ tejaḥ pratinavajapāpuṣparaktaṃ dadhānaḥ /	T12D4302:344b-9	ཚོགས་ཀྱི་མཛེས་མ་སེན་རྗེས་གསར་པས་གདུངས་ལ་ཁྱོད་ལས་ཆར་ཐིགས་ཐོབ་ན་ཚིམ་བྱེད་པ་༎ ཁྱོད་ལ་སྦྲང་རྩི་བྱེད་པའི་ཕྲེང་བ་བཞིན་དུ་ག-ཡོ་བའི་ཟུར་མིག་རིང་བ་དག་གིས་བལྟ་བར་འགྱུར་༎ ཕྱུགས་བདག་གླང་ཆེན་ལྤགས་རློན་འདོད་བཞིན་གྱོན་ནས་གར་ནི་རྩོམ་པ་འཕྲོགས་པར་གྱུར་པ་བཞིན་༎ ཁྱོད་འོངས་སྔ་དྲོའི་ཐུན་མཚམས་ཉི་གཞོན་དམར་བའི་འོད་ཀྱིས་དམར་བའི་ཆུ་སྐྱེས་འཛིན་བྱེད་ཅིང་༏
GK19kmeghvpu:74	 tāṃ kasyāṃ cid bhavanavalabhau suptapārāvatāyāṃ nītvā rātriṃ ciravilasanāt khinnavidyutkalatraḥ /  dṛṣṭe sūrye punar api bhavān vāhayed adhvaśeṣaṃ mandāyante na khalu suhṛdām abhyupetārthakṛtyāḥ // KMdV_38 //	T12D4302:345a-0	གང་ཕྱིར་སྙིང་གྲོགས་དག་གི་དོན་དུ་འབད་པ་༄༣༤༥ཨ་༌་༎ བྱས་པ་དེས་པར་བྱ་བ་བྱས་པ་ཉིད་༎ དེ་ཡི་དུས་སུ་ཉིན་མོར་བྱེད་པས་ལམ་ནི་དོར་ནས་མྱུར་དུ་འགྲོ་བར་བྱ་༎ འོད་ཟེར་རབ་ཏུ་འཕྲོ་བ་བསྒྲགས་ན་ཁྲོ་བ་ཆུང་བ་མིན་པ་ཁྱོད་ལ་བྱེད་པར་འགྱུར་༎
GK19kmeghvpu:76	 tasmin kāle nayanasalilaṃ yoṣitāṃ khaṇḍitānāṃ śāntiṃ neyaṃ praṇayibhir ato vartma bhānos tyajāśu /	T12D4302:345a-4	མཚན་མོ་བདག་པོ་སོང་བའི་བུད་མེད་མིག་གི་མཆི་མ་སེལ་ལ་བདག་པོ་འོང་བ་བཞིན་༎
GK19kmeghvpu:77	 prāleyāsraṃ kamalavadanāt so 'pi hartuṃ nalinyāḥ pratyāvṛttas tvayi kararudhi syād analpābhyasūyaḥ // KMdV_39 //	T12D4302:345a-5	པདམོའི་ཡུམ་གྱི་ཆུ་སྐྱེས་གདོང་གི་མིག་ཆུ་དེ་ཡང་རབ་ཏུ་སེལ་བ་བྱེད་པར་འགྱུར་༎
GK19kmeghvpu:78	 gambhīrāyāḥ payasi saritaś cetasīva prasanne chāyātmāpi prakṛtisubhago lapsyate te praveśam /	T12D4302:345a-6	རབ་དུ་དང་བའི་སེམས་བཞིན་ཤིན་ཏུ་ཟབ་མོ་དང་ལྡན་མཚོ་ཡི་ཆུ་ཡི་ཆུ་ཡི་ནང་དུ་ནི་༎ ཁྱོད་ཀྱི་གཟུགས་བརྙན་ཡང་ནི་རང་བཞིན་སྐལ་བ་བཟང་པོ་བདག་ཉིད་འཆར་བ་ཐོབ་པར་འགྱུར་༎
GK19kmeghvpu:79	 tasmāt tasyāḥ kumudaviśadāny arhasi tvaṃ na dhairyān moghīkartuṃ caṭulaśapharodvartanaprekṣitāni // KMdV_40 //	T12D4302:345a-8	དེ་སླད་དེ་ཡི་ཀུ་མུ་ཏ་ནི་དཀར་པོ་རྣམས་ཀྱིས་ཁྱོད་ལ་བཀུར་སྟི་བསྙེན་བཀུར་བྱེད་༎
