src_segmentnr	src_original	tgt_segmentnr	tgt_original
K01bhikavau:103	 varṣaśatopasaṃpannayā ānanda bhikṣuṇyā tad ahar upasaṃpannasya bhikṣor abhivādanavandanapratyutthānāñjalisāmīcīkarma kartavyam ity ayaṃ gautami bha/// @-----------------------------	T08D4118:139b-5	མིང་འདི་ཞེས་བྱ་བ་དགེ་སློང་མ་བསྙེན་པར་རྫོགས་ནས་ལོ་བརྒྱ་ལོན་པས་ཀྱང་དགེ་སློང་དེ་རིང་བསྙེན་པར་རྫོགས་པ་ལ་ཡང་གུས་པར་སྨྲ་བ་དང་། ཕྱག་བྱ་བ་དང་༎ དང་པོར་ལྡང་བ་དང་། ཐལ་མོ་སྦྱར་བ་དང་།
K01bhikavau:140	 iyam evaṃnāmikā evannāmikāyā pravrajyāpekṣā gṛhiṇī avadātavasanā anavatāritakeśā ākāṃkṣate (BhīKaVā 10b1)  svākhyāte dharmavinaye pravrajyāṃ seyam evaṃnāmikā keśān avatārya kāṣāyāṇi vastrāṇy	T08D4118:102b-13	ཁྱིམ་པ་གོས་དཀར་པོ་ཅན་སྐྲ་དང་ཁ་སྦུ་མ་བྲེགས་པ་ལས་ལེགས་པར་གསུངས་པའི་ཆོས་འདུལ་བ་ལ་རབ་ཏུ་འབྱུང་བར་འཚལ་ཏེ་། མིང་འདི་ཞེས་བགྱི་བ་འདི་རབ་ཏུ་འབྱུང་བར་འཚལ་ཞིང་སྐྲ་དང་ཁ་སྦུ་བྲེགས་ནས་གོས་དུར་སྨིག་བགོས་ཏེ་།
K01bhikavau:142	 ācchādya samyag eva śraddhayā agārād anāgārikāṃ pravrajyāṃ pravrajiṣyaty evaṃnāmikayā	T08D4118:102b-15	ཡང་དག་པ་ཁོ་ནར་དད་པས་ཁྱིམ་ནས་ཁྱིམ་མེད་པར་མཁན་པོ་མིང་འདི་ཞེས་བགྱི་བ་ལས་རབ་ཏུ་འབྱུང་སྟེ་། དེ་ཡང་བར་ཆད་ཀྱི་ཆོས་རྣམས་ཡོངས་སུ་དག་གོ་ཞེས་ཁོ་ན་ཉིད་མཆི་ན་ཅི་དེ་རབ་ཏུ་དབྱུང་ངམ་།
K01bhikavau:144	 sarvābhir vaktavyaṃ sacet pariśuddhā pravrajatu /	T08D4118:102b-17	དེ་དག་ཐམས་ཅད་ཀྱིས་གལ་ཏེ་ཡོངས་སུ་དག་ནའོ་ཞེས་བརྗོད་པར་བྱའོ་༎
K01bhikavau:145	 saced vadantīty evaṃ kuśalaṃ no ced vadanti sātisārā bhavanti /	T08D4118:102b-18	གལ་ཏེ་དེ་སྐད་བརྗོད་ན་ལེགས་། གལ་ཏེ་མི་བརྗོད་ན་འགལ་ཚབས་ཅན་དུ་འགྱུར་རོ་༎
K01bhikavau:146	 tataḥ paścād upādhyāyikā yācitavyā evaṃ punar yācitavyā /	T08D4118:102b-20	དེ་ནི་རབ་ཏུ་འབྱུང་བར་འདོད་བཞུ་བའོ་༎ དེའི་འོག་ཏུ་མཁན་པོར་གསོལ་བ་བྱའོ་༎
K01bhikavau:147	 sāmīcīṃ kārayitvā purata utkuṭukena niṣādyāñjaliṃ pragṛhya idaṃ syād vacanīyaṃ /  samanvāhara ācāryike 'ham evannāmikā ācāryikām upādhyāyikāṃ yāce ācāryikā me upādhyāyikā bhavatu /	T08D4118:102b-22	འདི་ལྟར་གསོལ་བར་བྱ་སྟེ་། མཁན་པོ་ལ་ཕྱག་འཚལ་དུ་བཅུག་ནས་མདུན་དུ་ཙོག་ཙོག་པོར་འདུག་ཏུ་བཅུག་སྟེ་ཐལ་མོ་སྦྱོར་དུ་བཅུག་ནས་དེས་འདི་སྐད་ཅེས་བརྗོད་པར་བྱ་སྟེ་། སློབ་དཔོན་དགོངས་སུ་གསོལ་།
K01bhikavau:149	 ācāryikayā upādhyāyikayā pravrajiṣyāmi /	T08D4118:102b-25	བདག་མིང་འདི་ཞེས་བགྱི་བ་སློབ་དཔོན་ལ་མཁན་པོར་གསོལ་གྱི་།
K01bhikavau:178	 evaṃ dvir apy evaṃ trir api // //	T08D4118:125a-0	དེ་བཞིན་དུ་ལན་གཉིས་༄༡༢༥ཨ་༌་༎ ལན་གསུམ་དུ་བཟླས་།
K01bhikavau:179	 tata upādhyāyikayā bhikṣuṇī adhyeṣṭavyā /  yāsyāḥ śrāmaṇerikāśikṣāpadāni dadāti /  tayā praṣṭavyaṃ /  pṛṣṭā te āntarāyikān dharmān iti /  apṛṣṭvā prayacchati sātisārā bhavati /	T08D4118:125a-2	མཁན་མོས་ཐབས་ཡིན་ནོ་ཞེས་བརྗོད་པར་བྱའོ་༎ སློབ་མས་ལེགས་སོ་ཞེས་བརྗོད་པར་བྱའོ་༎ དེ་ནི་ཆོས་གོས་མ་དྲས་ཤིང་མ་དྲུབས་པ་ལྔ་བྱིན་གྱིས་བརླབ་པའོ་༎ དེའི་འོག་ཏུ་ལྷུང་བཟེད་བསྟན་པར་བྱའོ་༎
K01bhikavau:184	 yā adhīṣṭā tayā śāstuḥ praṇāmaṃ kārayitvā ā/// @------------------------------  (BhīKaVā 15a1) + + tataś cīvarāṇy adhiṣṭhātavyāni /  samanvāhara upādhyāyike aham evannāmikā idaṃ cīvaraṃ saṃghāṭīm adhitiṣṭhāmi kṛtapariniṣṭhitañ cīvaraṃ kalpikaṃ pāribhogikaṃ /	T08D4118:125a-6	འདི་ལྟར་བསྟན་པར་བྱ་སྟེ་། དགེ་སློང་མ་གཅིག་གིས་ལྷུང་བཟེད་ལག་པ་ག-ཡོན་པར་བཞག་སྟེ་། ལག་པ་ག-ཡས་པས་བཀབ་ནས་རྒན་པའི་མཐའ་ལོགས་ནས་དགེ་སློང་མ་རེ་རེའི་མདུན་དུ་འགྲེང་སྟེ་འདུད་པ་དང་བཅས་པས་འདི་སྐད་ཅེས་བརྗོད་པར་བྱ་སྟེ་།
K01bhikavau:191	 samanvāhara āyuṣmati idam āyuṣmatyā amukāyāḥ pātraṃ mā ūnaṃ mā adhikaṃ mā pāṇḍu ceti /	T08D4118:125a-9	འཕགས་མ་དགོངས་སུ་གསོལ་། ཚེ་དང་ལྡན་པ་མིང་འདི་ཞེས་བགྱི་བའི་ལྷུང་བཟེད་འདི་མི་ཆུང་ངམ་། མི་ཆེའམ་། མི་སྐྱའམ་།
K01bhikavau:192	 śobhanañ caiva sarvābhir bhikṣuṇībhir vaktavyaṃ supātram iti /	T08D4118:125a-12	དགེ་སློང་མ་ཐམས་ཅད་ཀྱིས་ཀྱང་ལྷུང་བཟེད་དེ་ལྟ་བུ་ཉིད་མ་ཡིན་ན་རེ་རེ་ནས་ལྷུང་བཟེད་བཟང་ངོ་ཞེས་བརྗོད་པར་བྱའོ་༎
K01bhikavau:334	 jīvatas te mātāpitarau svāmī vā jīvati /  anujñātāsi mātāpitṛbhyāṃ svāminā vā /  anujñātā /  māsi dāsī /	T08D4118:117b-12	ཕ་མ་དང་ཁྱིམ་ཐབ་ཀྱིས་མ་གནང་བ་མ་ཡིན་ནམ་། ཕ་མ་དང་ཁྱིམ་ཐབ་ཀྱིས་མ་གནང་བ་ཡུལ་ཐག་མི་རིང་བ་མ་ཡིན་ནམ་། ནད་པ་མ་ཡིན་ནམ་།
K01bhikavau:338	 na hi mā āhṛtikā /  mā vikrītikā /  mā vaktavyikā /  mā nirmitikā /  mā rājabhaṭī /	T08D4118:117b-15	དགེ་སློང་སུན་ཕྱུང་བ་མ་ཡིན་ནམ་། རྐུ་ཐབས་སུ་གནས་པ་མ་ཡིན་ནམ་། ཟ་མ་མ་ཡིན་ནམ་།
K01bhikavau:349	 mā mātṛghātikā /  mā pitṛghātikā (BhīKaVā 20a1) /	T08D4118:117b-23	ཕ་བསད་པ་མ་ཡིན་ནམ་། དགྲ་བཅོམ་པ་བསད་པ་མ་ཡིན་ནམ་།
K01bhikavau:351	 mā arhadghātikā /  mā tathāgatasyāntike duṣṭacittarudhirotpādikā mā tīrthikā mā tīrthāvakrāntikā mā caurī mā dhvajabaddhikā mā steyasaṃvāsikā mā nānāsaṃvāsikā mā asaṃvāsikā /	T08D4118:117b-25	དེ་བཞིན་གཤེགས་པ་ལ་ངན་སེམས་ཀྱིས་ཁྲག་ཕྱུང་བ་མ་ཡིན་ནམ་།
K01bhikavau:345	 mā sadāprasrutalohinī /  mā alohinī /  mā naimittikī /  mā bhikṣudūṣikā /  mā mātṛghātikā /  mā pitṛghātikā (BhīKaVā 20a1) /	T08D4118:126a-28	གླེ་འདམས་པ་མ་ཡིན་ནམ་། རྟག་ཏུ་ཟླ་མཚན་ཟག་པ་མ་ཡིན་ནམ་། ཟླ་མཚན་མི་ཟག་པ་མ་ཡིན་ནམ་། མཚན་མ་མེད་པ་མ་ཡིན་ནམ་། མཚན་མ་ཙམ་ཡོད་པ་མ་ཡིན་ནམ་།
K01bhikavau:353	 kaccit tvaṃ pūrvaṃ pravrajiteti yadi kathayati pravrajitā vaktavyā ata eva gaccheti yadi kathayati na pravrajiteti vaktavyā kaccid etarhi pravrajitā	T08D4118:126a-44	དེས་ལེགས་པར་སྤྱད་ཅེས་བརྗོད་པར་བྱའོ་༎ ཇི་ལྟར་ཁྱོད་ཀྱིས་དགེ་སློང་མའི་དགེ་འདུན་ལས་ལོ་གཉིས་སུ་ཆོས་༄༡༢༦བ་དྲུག་དང་རྗེས་སུ་མཐུན་པའི་ཆོས་དྲུག་ལ་བསླབ་པའི་སྡོམ་པ་གསོལ་ཏམ་། དས་གསོལ་ཞེས་བརྗོད་པར་བྱའོ་༎ ཇི་ལྟར་ཁྱོད་ཀྱིས་ལོ་གཉིས་སུ་ཆོས་དྲུག་དང་རྗེས་སུ་མཐུན་པའི་ཆོས་དྲུག་ལ་བསླབས་སམ་།
K01bhikavau:363	 mā tvayā kasya cit kiñ cid deyaṃ alpaṃ vā prabhūtaṃ vā kinnāmikā tvaṃ kinnāmikā te upādhyāyikā aham evannāmikā arthahetor (BhīKaVā 20b1)  nāma gṛhṇāmi evannāmikā me upādhyāyikā /	T08D4118:126b-3	དེས་བསླབས་ཞེས་བརྗོད་པར་བྱའོ་༎ ཁྱོད་ཀྱི་མིང་ཅི་། ཁྱོད་ཀྱི་མཁན་མོའི་མིང་ཅི་༏་དེས་བདག་མིང་འདི་ཞེས་བགྱི་། བདག་གི་མཁན་མོའི་མིང་ནི་འདི་ཞེས་བགྱི་ཞེས་བརྗོད་པར་བྱའོ་༎
K01bhikavau:365	 śṛṇu tvam evannāmike bhavanti khalu strīṇām ima evaṃvidhāḥ kāye kāyikā ābādhāḥ /	T08D4118:126b-9	མིང་འདི་ཞེས་བྱ་བ་ཁྱོད་ཉོན་ཅིག་། བུད་མེད་རྣམས་ཀྱི་ལུས་ལ་ལུས་ཀྱི་ནད་རྣམ་པ་འདི་ལྟ་བུ་འདི་དག་འབྱུང་བ་འདི་ལྟ་སྟེ་།
K01bhikavau:407	 yācate evannāmikayā upādhyāyikayā tad ubhayasaṃgha evannāmikām upasaṃpādayed evannāmikayā  upādhyāyikayā yeṣām āyuṣmatāṃ kṣamate evannāmikām upasaṃpādayitum evannāmikayā upādhyāyikayā  te tūṣṇīṃ yeṣāṃ na kṣamate te bhāṣantāṃ /  iyaṃ prathamā karmavācanā /	T08D4118:132a-3	དེའི་སླད་དུ་གཉི་གའི་དགེ་འདུན་གྱིས་མིང་འདི་ཞེས་བགྱི་བ་མཁན་མོ་མིང་འདི་ཞེས་བགྱི་བས་བསྙེན་པར་རྫོགས་པར་མཛད་ན་། ཚེ་དང་ལྡན་པ་གང་དག་མིང་འདི་ཞེས་བགྱི་བ་མཁན་མོ་མིང་འདི་ཞེས་བགྱི་བས་བསྙེན་པར་རྫོགས་པར་མཛད་པར་བཟོད་པ་དེ་དག་ནི་ཅང་མ་གསུང་ཤིག་། གང་དག་མི་བཟོད་པ་དེ་དག་ནི་གསུངས་ཤིག་།འདི་ནི་ལས་བརྗོད་པ་དང་པོ
K01bhikavau:411	 evaṃ dvitīyā tṛtīyā karmavācanā vaktavyā /	T08D4118:132a-5	སྟེ་། དེ་བཞིན་དུ་ལན་གཉིས་ལན་གསུམ་དུ་བཟླས་།
K01bhikavau:412	 upasaṃpāditā ubhayasaṃghena iyam evannāmikā evannāmikayā upādhyāyikayā kṣāntam anujñātaṃ saṃghena yasmāt tūṣṇīm evam etad dhārayāmi /	T08D4118:132a-6	གཉི་གའི་དགེ་འདུན་གྱིས་བཟོད་ཅིང་གནང་ནས་གཉི་གའི་དགེ་འདུན་གྱིས་མིང་འདི་ཞེས་བགྱི་བ་མཁན་མོ་མིང་འདི་ཞེས་བགྱི་བས་བསྙེན་པར་རྫོགས་པར་མཛད་ལགས་ཏེ་། འདི་ལྟར་ཅང་མི་གསུང་བས་དེ་དེ་བཞིན་དུ་འཛིན་ཏོ་༎ དེ་ནི་དགེ་སླང་མ་བསྙེན་པར་རྫོགས་པར་ཉེ་བར་སྒྲུབ་པའི་ཆོ་ག་དང་ལས་སོ་༎ དེའི་འོག་ཏུ་དགེ་སློང་མ་ལས་བྱེད་པ་མ་ཡིན་པ་གཞན་གང་ཡང་རུང་བ་གཅིག་གིས་གྲིབ་ཚོད་གཞལ་བར་བྱའོ་༎ འདི་ལྟར་བྱ་སྟེ་། ཐུར་མ་སོར་བཞི་ཙམ་གྱིས་གཞལ་བར་བྱ་ཞིང་ཐུར་མ་ཇི་ཙམ་ཡོད་པ་དེ་ཙམ་ལས་སྐྱེས་བུ་ཞེས་བརྗོད་པར་བྱ་།
K01bhikavau:413	 tataḥ cchāyā māpayitavyā /	T08D4118:132a-12	སོར་རེ་རེ་ལ་རྩ་བ་རེ་རེ་ཞེས་བརྗོད་པར་བྱའོ་༎ དེ་ནི་གྲིབ་ཚོད་གཞལ་བར་བྱའོ་༎ དེའི་འོག་ཏུ་ཉིན་མཚན་གྱི་ཆ་བརྗོད་པར་བྱ་སྟེ་།
K01bhikavau:425	 tatra haimantikāś catvāro māsāḥ graiṣmikāś catvāro māsāḥ /	T08D4118:132b-1	དེ་ལ་དགུན་གྱི་དུས་ནི་ཟླ་བ་བཞིའོ་༎ དཔྱིད་ཀྱི་དུས་ནི་ཟླ་བ་བཞིའོ་༎
K01bhikavau:424	 haimantikā graiṣmikā vārṣikā mṛtavārṣikā dīrghavārṣikāś ca /	T08D4118:132b-0	དགུན་གྱི་དུས་དང་། དཔྱིད་༄༡༣༢བ་ཀྱི་དུས་དང་། དབྱར་གྱི་དུས་དང་། དབྱར་ཐུང་དུའི་དུས་དང་། དབྱར་རིང་པོའི་དུས་སོ་༎
K01bhikavau:426	 vārṣika eko māsaḥ /	T08D4118:132b-3	དབྱར་གྱི་དུས་ནི་ཟླ་བ་གཅིག་གོ་༎
K01bhikavau:427	 mitavārṣika ekaṃ rātriṃdivaṃ /  dīrghavārṣikā ekarātronās trayo māsāḥ /	T08D4118:132b-4	དབྱར་ཐུང་དུའི་དུས་ནི་ཉིན་ཞག་གཅིག་གོ་༎ དབྱར་རིང་བོའི་དུས་ནི་ཉིན་ཞག་གཅིག་གིས་ཟླ་བ་གསུམ་དུ་མ་ཆོག་པ་སྟེ་།
K01bhikavau:429	 kāla ārocayitavyaḥ /	T08D4118:132b-6	དེ་ནི་དུས་ཚོད་བརྗོད་པའོ་༎
K01bhikavau:444	 tatas trayo (BhīKaVā 22b1)  niśrayā ārocayitavyāḥ /	T08D4118:132b-15	དེས་སྤྲོ་ཞེས་བརྗོད་པར་བྱའོ་༎
K01bhikavau:454	 atirekalābhaḥ paṭṭo vā paṭo vā prāvāro vā aṃśukā vā śāṇakā vā kauśeyā va āmilā vā  somilā vā kṛmivarṇā vā kāśisūkṣmaṃ vā kṣomakasūkṣmaṃ vā dukūlakasūkṣmaṃ vā koṭambakasūkṣmaṃ	T08D4118:132b-24	ཡུལ་ཀ་ཤི་ཀའི་རས་ཕྲན་ནམ་། ཁ་དོག་རན་པའམ་། ཁ་དོག་ངན་པའམ་། བལ་གོས་སམ་། ཤ་ནའི་རས་སམ་། ཀོ་ཏ་པའི་རས་སམ་། ཉི་འོག་གི་རས་སམ་།
K01bhikavau:456	 vā iti yad vā punar anyad api kalpikañ cīvaraṃ saṃghād vā utpadyeta pudgalato vā  tatrāpi te pratigrahe mātrā karaṇīyā /	T08D4118:132b-34	གཞན་ཡང་གོས་རུང་བ་གང་དགེ་འདུན་ནམ་གང་ཟག་ལ་ས་རྙེད་ན་དེ་ཡང་ཁྱོད་ཀྱིས་ལོང་ལ་ཚོད་ཟིན་པར་གྱིས་ཤིག་། ཇི་ལྟར་ཁྱོད་གནས་འདི་ལྟ་བུ་ལ་དམ་འཆ་འམ་དེས་འཆའ་ཞེས་བརྗོད་པར་བྱའོ་༎
K01bhikavau:460	 śṛṇu tvam evannāmike piṇḍapāto bhojanānām agraś ca kalpikaś ca sulabhaś ca yan niśritya bhikṣuṇyāḥ svākhyāte dharmavinaye pravrajyopasaṃpad bhikṣuṇībhāvaḥ /	T08D4118:133a-1	སློང་མ་ལེགས་པར་གསུངས་པའི་ཆོས་འདུལ་བ་ལ་རབ་ཏུ་བྱུང་བ་དང་བསྙེན་པར་རྫོགས་པ་དགེ་སློང་མའི་དངོས་པོར་འགྱུར་རོ་༎ མིང་འདི་ཞེས་བྱ་བ་ཁྱོད་ཇི་སྲིད་འཚོའི་བར་དུ་བསོད་སྙོམས་ཀྱི་ཟས་ཀྱིས་འཚོ་བར་སྤྲོའམ་།
K01bhikavau:461	 utsahase tvam evannāmike yāvajjīvaṃ piṇḍapātena bhojanena yāpayitum utsahe /	T08D4118:133a-3	དེས་སྤྲོ་ཞེས་བརྗོད་པར་བྱའོ་༎ ལྷག་པར་རྙེད་ན་འབྲས་ཆན་ནམ་། སྐྱོ་མའམ་། ཐུག་པའམ་། ལྔ་སྟོན་ནམ་། བརྒྱད་སྟོན་ནམ་།
K01bhikavau:463	 bhaktāni vā tarppaṇāni vā yavāgūpānāni vā naityakaṃ vā nimantraṇakaṃ vā āṣṭamikaṃ vā cāturdaśikaṃ vā iti yad vā punar anyad api kalpikaṃ bhojanaṃ saṃghād vā utpadyeta /  pudgalato vā tatrāpi te pratigrahe mātrā karaṇīyā /  kaccid evaṃrūpaṃ sthānam abhisaṃbhotsyase /	T08D4118:133a-8	བཅུ་བཞི་སྟོན་ནམ་། ཉ་སྟོན་ནམ་། རྟག་རེས་འཁོར་རམ་། མགྲོན་དུ་བོས་པའམ་། འཕྲལ་ལ་བོས་པའམ་། སྤགས་པའམ་། གཞན་ཡང་ཟས་རུང་བ་གང་དགེ་འདུན་ནམ་གང་ཟག་ལས་རྙེད་ན་དེ་ཡང་ཁྱོད་ཀྱིས་ལོང་ལ་ཚོད་ཟིན་པར་གྱིས་ཤིག་། ཇི་ལྟར་ཁྱོད་གནས་འདི་ལྟ་བུ་ལ་དམ་འཆ་འམ་།
K01bhikavau:470	 sarpis tailam (BhīKaVā 23b1)  madhu phāṇitaṃ mūlabhaiṣajyaṃ gaṇḍabhaiṣajyaṃ pattrabhaiṣajyaṃ puṣpabhaiṣajyaṃ phalabhaiṣajyaṃ kālikaṃ yāmikaṃ sāptāhikaṃ yāvajjīvikam iti /	T08D4118:133a-19	ལྷག་པར་རྙེད་ན་ཞུན་མར་རམ་། འབྲུ་མར་རམ་། སྦྲང་རྩི་འམ་། དུས་སུ་རུང་བའམ་། ཐུན་ཚོད་དུ་རུང་བའམ་། ཞག་བདུན་པའམ་། འཚོ་བའི་བར་དུ་བཅང་བའམ་།
K01bhikavau:472	 yad vā punar anyad api kalpikaṃ bhaiṣajyaṃ saṃghād vā utpadyeta pudgalato vā tatrāpi te pratigrahe mātrā karaṇīyā kaccid evaṃrūpaṃ sthānam abhisaṃbhotsyase	T08D4118:133a-27	རྩ་བའི་སྨན་ནམ་། སྡོང་བུའི་སྨན་ནམ་། ལོ་མའི་སྨན་ནམ་། འབྲས་བུའི་སྨན་ནམ་། གཞན་ཡང་སྨན་རུང་བ་གང་དགེ་འདུན་ནམ་གང་ཟག་ལས་རྙེད་ན་དེ་ཡང་ཁྱོད་ཀྱིས་ལོང་ལ་ཚོད་ཟིན་པར་གྱིས་ཤིག་། ཇི་ལྟར་ཁྱོད་གནས་འདི་ལྟ་བུ་ལ་དམ་འཆ་འམ་།
K01bhikavau:474	 śṛṇu tvam evannāmike aṣṭāv ime tena bhagavatā jānatā paśyatā tatha  āgatenārhatā samyaksaṃbuddhenaivaṃ pravrajitopasaṃpannāyā bhikṣuṇyāḥ patanīyā dharmā  ākhyātā yeṣāṃ bhikṣuṇī anyatamānyatamat sthānaṃ adhyāpadya sahādhyāpattyā abhikṣuṇī	T08D4118:133b-0	མིང་འདི་ཞེས་བྱ་བ་ཁྱོད་ཉོན་ཅིག་། བརྒྱད་པོ་འདི་དག་ནི་བཅོམ་ལྡན་འདས་དེ་བཞིན་གཤེགས་པ་དགྲ་བཅོམ་པ་ཡང་དག་པར་རྫོགས་པའི་སངས་རྒྱས་མཁྱེན་ཅིང་གཟིགས་པ་དེས་དེ་ལྟར་རབ་ཏུ་བྱུང་བ་དང་བསྙེན་པར་རྫོགས་པ་༄༡༣༣བ་དགེ་སློང་མའི
K01bhikavau:477	 bhavaty aśramaṇī aśākyaputrīyā dhvasyate bhikṣuṇībhāvād dhatam asyā bhavati śrāmaṇyaṃ  dhvastaṃ mathitaṃ patitaṃ parājitam apratyuddhāryam asyā bhavati śrāmaṇyaṃ /	T08D4118:133b-2	དགེ་སློང་མས་དེ་བྱས་ན་བྱས་མ་ཐག་ཏུ་དགེ་སློང་མར་མི་རུང་བར་འགྱུར་།
K01bhikavau:479	 tadyathā tālo mastakāc chinnaḥ /  evam eva bhikṣuṇī eṣām aṣṭānāṃ sthānānām anyatamānyatamat sthānam adhyāpadya sahādhyāpattyā	T08D4118:133b-3	དགེ་སྦྱོང་དུ་མི་རུང་།
K01bhikavau:482	 abhikṣuṇī bhavaty aśramaṇī aśākyaputrīyā dhvasyate bhikṣuṇībhāvād dhatam asyā bhavati	T08D4118:133b-4	ཤའཀྱའི་སྲས་ཀྱིར་མི་རུང་། དགེ་སློང་མའི་དངོས་པོ་ལས་ཉམས་བར་འགྱུར་ཏེ་། དེའི་དགེ་སྦྱོང་གི་ཚུལ་ཞིག་པར་འགྱུར་ཞིང་།
K01bhikavau:483	 śrāmaṇyaṃ dhvastaṃ mathitaṃ patitaṃ parājitam apratyuddhāryam asyā bhavati śrāmaṇyaṃ katame aṣṭau /	T08D4118:133b-7	ཉམས་པ་། བཅོམ་པ་། ལྟུང་བ་རམ་པར་གྱུར་པ་སྟེ་། དེའི་དགེ་སྦྱོང་གི་ཚུལ་ཕྱིར་བླང་དུ་མེད་པར་འགྱུར་རོ་༎ འདི་ལྟ་སྟེ་དཔེར་ན་ཤིང་ཏ་ལའི་མགོ་བཅད་ན་སྔོན་པོར་འགྱུར་དུ་མི་རུང་ལ་། འཕེལ་ཞིང་རྒྱས་པ་དང་ཡངས་པར་འགྱུར་དུ་མི་རུང་བ་བཞིན་ནོ་༏་། བརྒྱད་གང་ཞེ་ན་།
K01bhikavau:484	 śṛṇu tvam evannāmike anekaparyāyeṇa bhagavatā kāmā vigarhitāḥ kāmacchandaḥ /  kāmasnehaḥ /  kāmapremaḥ kamālayaḥ /	T08D4118:133b-13	འདོད་པ་དང་། འདོད་པ་ལ་ཞེན་པ་དང་། འདོད་པ་ལ་འཆུམས་པ་དང་། འདོད་པ་ལ་ལྷག་པར་ཞེན་པ་ནི་བཅོམ་ལྡན་འདས་ཀྱིས་རྣམ་གྲངས་དུ་མས་སྨད་དོ་༎
K01bhikavau:487	 kāmaniyantiḥ /  kāmānāṃ prahāṇam ākhyātaṃ pratiniḥsargo vyantībhāvaḥ /  kṣayo virāgo nirodho vyupaśamo 'staṅgamaḥ /	T08D4118:133b-14	འདོད་པ་སྤངས་པ་ནི་བསྔགས་ཏེ་བོར་བ་དང་། བསྩལ་བ་དང་། ཟད་པ་དང་། འདོད་ཆགས་དང་བྲལ་བ་དང་། འགོག་པ་དང་། ཉེ་བར་ཞི་བ་དང་། ནུབ་པ་ནི་བསྟོད་དོ་༎
K01bhikavau:491	 stutaḥ stomito varṇitaḥ praśasto 'dyāgreṇa te evannāmike saṃraktacittayā puruṣaś cakṣuṣā cakṣur upanidhyāyatyā na vyavalokayitavyaḥ /	T08D4118:133b-15	བཀུར་རོ་། བསྔགས་སོ་༎ སྙན་པར་བརྗོད་དོ་༎ མིང་འདི་ཞེས་བྱ་བ་ཁྱོད་དེང་ཕྱིན་ཆད་ཆགས་པའི་སེམས་ཀྱིས་སྐྱེས་པ་ལ་མིག་གཏད་དེ་། མིག་གིས་བལྟ་བར་ཡང་མི་བྱ་ན་།
K01bhikavau:492	 kaḥ punar vādo yad dvayadvayendriyasamāpattyā abrahmacaryam maithunaṃ dharmaṃ pratisevitum	T08D4118:133b-19	གཉིས་ཀྱིས་གཉིས་སྤྲད་དེ་མི་ཚངས་པར་སྤྱོད་པ་འཁྲིག་པའི་ཆོས་བསྟེན་པ་ལྟ་སྨོས་ཀྱང་ཅི་དགོས་།
K01bhikavau:496	 evaṃrūpaṃ bhikṣuṇī sthānam adhyāpadya sahādhyāpattyā abhikṣuṇī bhavaty aśramaṇī aśākyaputrīyā  dhvasyate bhikṣuṇībhāvād dhatam asyā bhavati śrāmaṇyaṃ dhvastaṃ mathitaṃ patitaṃ	T08D4118:133b-25	ཤའཀྱའི་སྲས་ཀྱིར་མི་རུང་། དགེ་སློང་མའི་དངོས་པོ་ལས་ཉམས་པར་འགྱུར་ཏེ་། དེའི་དགེ་སྦྱོང་གི་ཚུལ་ཞིག་པར་འགྱུར་ཞིང་༄༡༣༤ཨ་༌་༎ ཉམས་པ་༏་བཅོམ་པ་། ལྟུང་བ་། ཕམ་པར་གྱུར་པ་སྟེ་། དེའི་དགེ་སྦྱོང་གི་ཚུལ་ཕྱིར་བླང་དུ་མེད་པར་འགྱུར་རོ་༎
K01bhikavau:498	 parājitam apratyuddhāryam asyā bhavati śrāmaṇyaṃ tadyathā tālo mastakāc chinno 'bhavyo	T08D4118:134a-4	འདི་ལྟ་སྟེ་དཔེར་ན་ཤིང་ཏ་ལའི་མགོ་བཅད་ན་སྔོན་པོར་འགྱུར་དུ་མི་རུང་ལ་།
K01bhikavau:503	 tīvraś cetasa ārakṣāsmṛtyapramāde yogaḥ karaṇīyaḥ /  kaccid evaṃrūpaṃ sthānaṃ nādhyāpatsyase /  nādhyāpatsye /	T08D4118:134a-6	དེང་ཕྱིན་ཆད་ཁྱོད་སྤྱད་པ་མ་ཡིན་པ་དང་། བྱ་བ་མ་ཡིན་པ་དང་། སྤྱད་པ་མ་ཡིན་པ་སྤང་པ་དེ་ལ་དྲན་པ་དང་བག་ཡོད་པས་སེམས་ཤིན་ཏུ་བསྲུང་བ་ལ་བརྩོན་པར་གྱིས་ཤིག་། ཇི་ལྟར་གནས་འདི་ལྟ་བུ་ལ་མི་སྤྱོད་དམ་།
K01bhikavau:507	 anekaparyāyeṇa bhagavatā adattādānaṃ vigarhitaṃ adattādānaviratiḥ /	T08D4118:134a-8	། མིང་འདི་ཞེས་བྱ་བ་ཁྱོད་ཉོན་ཅིག་། མ་བྱིན་པར་ལེན་པ་ནི་བཅོམ་ལྡན་འདས་ཀྱིས་རྣམ་གྲངས་དུ་མས་སྨད་དོ་༎ མ་བྱིན་པར་ལེན་པ་སྤངས་པ་ནི་བསྟོད་དོ་༎ བཀུར་རོ་༎ བསྔགས་སོ་༎ སྙན་པར་བརྗོད་དོ་༎
K01bhikavau:508	 stutā stomitā varṇitā praśastā adyāgreṇa te evannāmike steyacittayāntatas tilatuṣam api parakīyan nādātavyaṃ kaḥ punar vādaḥ pañcamāsikaṃ vā uttarapañcamāsikaṃ vā	T08D4118:134a-12	མིང་འདི་ཞེས་བྱ་བ་ཁྱོད་དེང་ཕྱིན་ཆད་རྐུ་སེམས་ཀྱིས་གཞན་གྱི་ཏིལ་གྱི་ཕུབ་མ་ཡང་མ་བྱིན་པར་མི་བླང་ན་མ་ཤ་ཀ་ལྔའམ་། མ་ཤ་ཀ་ལྔ་ལས་ལྷག་པ་ལྟ་སྨོས་ཀྱང་ཅི་དགོས་།
K01bhikavau:509	 uktaṃ bhagavatā /  yā punar bhikṣuṇī grāmagataṃ vā araṇyagataṃ vā pareṣām adattaṃ steyasaṃkhyātam ādadīta	T08D4118:134a-14	མིང་འདི་ཞེས་བྱ་བ་ཁྱོད་བཅོམ་ལྡན་འདས་དེ་བཞིན་གཤེགས་པ་དགྲ་བཅོམ་པ་ཡང་དག་པར་རྫོགས་པའི་སངས་རྒྱས་མཁྱེན་ཅིང་གཟིགས་པ་དེས་ཡང་དགེ་སློང་མ་གང་གཞན་དག་གི་གྲོང་ན་འདུག་པའམ་། དགོན་པ་ན་འདུག་པ་མ་བྱིན་པ་རྐུ་བའི་གྲངས་སུ་གཏོགས་པ་བླངས་ན་།
K01bhikavau:511	 yadrūpeṇādattādānena rājā vainaṃ gṛhītvā rājamātro vā hanyād vā badhnīyād vā pravāsayed	T08D4118:134a-16	ཇི་ཙམ་མ་བྱིན་པར་བླངས་པས་དེ་རྒྱལ་པོའམ་། བློན་པོ་ཆེན་པོས་བཟུང་ནས་དེ་ལ་འདི་སྐད་ཅེས་ཀྱི་བུད་མེད་ཁྱོད་ནི་རྐུན་མའོ༎
K01bhikavau:512	 vā evaṃ cainaṃ vaded dhaṃ bhoḥ puruṣa cauro 'si bālo 'si mūḍho 'si steyo 'sīty	T08D4118:134a-18	བྱིས་པའོ་༎ བླུན་པའོ་། རྐུ་བའོ་ཞེས་ཟེར་ཞིང་གསོད་དམ་འཆིང་ངམ་སྤྱུགས་ཀྱང་རུང་སྟེ་།
K01bhikavau:513	 evaṃrūpaṃ bhikṣuṇī sthānam adhyāpadya sahādhyāpattyābhikṣuṇī bhavaty aśramaṇī aśākyaputrīyā pūrvavad yāvat smṛtyapramāde yogaḥ karaṇīyaḥ /	T08D4118:134a-20	དགེ་སློང་མ་དེ་ལྟར་མ་བྱིན་པར་ལེན་ན་དགེ་སློང་མ་དེ་ཡང་ཕམ་པར་གྱུར་པ་ཡིན་གྱིས་གནས་པར་མི་བྱའོ་ཞེས་བྱ་བ་འདི་བཀའ་སྩལ་ཏེ་། དགེ་སློང་མས་གནས་འདི་ལྟ་བུ་བྱས་ན་བྱས་མ་ཐག་ཏུ་དགེ་སློང་མར་མི་རུང་བར་འགྱུར་། དགེ་སྦྱོང་དུ་མི་རུང་། ཤའཀྱའི་སྲས་ཀྱིར་མི་རུང་།
K01bhikavau:514	 kaccid evaṃrūpaṃ sthānaṃ nādhyāpatsyase /	T08D4118:134a-25	ཉམས་པ་། བཅོམ་པ་། ལྟུང་བ་། ཕམ་པར་གྱུར་པ་སྟེ་། དེའི་དགེ་སྦྱོང་གི་ཚུལ་༄༡༣༤བ་ཕྱིར་བླང་དུ་མེད་པར་འགྱུར་རོ་༎ འདི་ལྟ་སྟེ་དཔེར་ན་ཤིང་ཏ་ལའི་མགོ་བཅད་ན་སྔོན་པོར་འགྱུར་དུ་མི་རུང་ལ་། འཕེལ་ཞིང་རྒྱས་པ་དང་ཡངས་པར་འགྱུར་དུ་མི་རུང་བ་བཞིན་ནོ་༎ དེང་ཕྱིན་ཆད་ཁྱོད་སྤྱད་པ་མ་ཡིན་པ་དང་། བྱ་བ་མ་ཡིན་པ་དང་། སྤྱད་པ་མ་ཡིན་པ་སྤང་བ་དེ་ལ་དྲན་པ་དང་བག་ཡོད་པས་སེམས་ཤིན་ཏུ་བསྲུང་བར་བརྩོན་པར་གྱིས་ཤིག་། ཇི་ལྟར་གནས་འདི་ལྟ་བུ་ལ་མི་སྤྱོད་དམ་།
K01bhikavau:515	 nādhyāpatsye /	T08D4118:134b-4	དེས་མི་སྤྱོད་ཅེས་བརྗོད་པར་བྱའོ་༎
K01bhikavau:516	 śṛṇu tvam evaṃnāmike anekaparyāyeṇa bhagavatā prāṇātipāto vigarhitaḥ prāṇātipātād viratiḥ stutā stomitā varṇitā (BhīKaVā 25b1)	T08D4118:134b-5	མིང་འདི་ཞེས་བྱ་བ་ཁྱོད་ཉོན་ཅིག་། སྲོག་གཅོད་པ་ནི་བཅོམ་ལྡན་འདས་ཀྱིས་རྣམ་གྲངས་དུ་མས་སྨད་དོ་༎ སྲོག་གཅོད་པ་སྤངས་པ་ནི་བསྟོད་དོ་༎ བཀུར་རོ་༎ བསྔགས་སོ་༎ སྙན་པར་བརྗོད་དོ་༎
K01bhikavau:517	 praśastā adyāgreṇa te evaṃnāmike saṃcintyāntataḥ kuntapipīliko pi prāṇī jīvitān na vyaparopayitavyaḥ /	T08D4118:134b-9	མིང་འདི་ཞེས་བྱ་བ་ཁྱོད་དེང་ཕྱིན་ཆད་བསམས་བཞིན་དུ་སྲོག་ཆགས་གྲོག་སྦུར་ཡང་གསད་པར་མི་བྱ་ན་།
K01bhikavau:424	 haimantikā graiṣmikā vārṣikā mṛtavārṣikā dīrghavārṣikāś ca /  tatra haimantikāś catvāro māsāḥ graiṣmikāś catvāro māsāḥ /	T08D4118:110b-7	དཔྱིད་ཀྱི་དུས་ཀྱང་ཟླ་བ་བཞིའོ་༎
K01bhikavau:426	 vārṣika eko māsaḥ /	T08D4118:110b-8	དབྱར་གྱི་དུས་ནི་ཟླ་བ་གཅིག་གོ་༎
K01bhikavau:427	 mitavārṣika ekaṃ rātriṃdivaṃ /  dīrghavārṣikā ekarātronās trayo māsāḥ /  kāla ārocayitavyaḥ /	T08D4118:110b-9	དབྱར་ཐུང་དུའི་དུས་ནི་ཉིན་ཞག་གཅིག་གོ་༎ དབྱར་རིང་པོའི་དུས་ནི་ཉིན་ཞག་གཅིག་གིས་ཟླ་བ་གསུམ་དུ་མཆོག་པ་སྟེ་།
K01bhikavau:443	 ity evamādiḥ /  tatas trayo (BhīKaVā 22b1)  niśrayā ārocayitavyāḥ /	T08D4118:110b-12	དེའི་འོག་ཏུ་དགེ་སློང་ལས་བྱེད་པས་གནས་རྣམས་བརྗོད་པར་བྱ་སྟེ་།
K01bhikavau:446	 śṛṇu tvam evannāmike traya ime tena bhagavatā jānatā paśyatā tathāgatenārhatā samyaksaṃbuddhena  evaṃ pravrajitopasaṃpannāyā bhikṣuṇyā niśrayā ākhyātā yān niśritya bhikṣuṇyāḥ svākhyāte	T08D4118:110b-13	ཚེ་དང་ལྡན་པ་མིང་འདི་ཞེས་བྱ་བ་ཁྱོད་ཉོན་ཅིག་། བཞི་པོ་འདི་དག་ནི་བཅོམ་ལྡན་འདས་དེ་བཞིན་གཤེགས་པ་དགྲ་བཅོམ་པ་ཡང་དག་པར་རྫོགས་པའི་སངས་རྒྱས་མཁྱེན་ཅིང་གཟིགས་པ་དེས་དེ་ལྟར་རབ་ཏུ་བྱུང་བ་དང་བསྙེན་པར་རྫོགས་པའི
K01bhikavau:506	 śṛṇu tvam evannāmike (BhīKaVā 25a1)  anekaparyāyeṇa bhagavatā adattādānaṃ vigarhitaṃ adattādānaviratiḥ /	T08D4118:112b-0	ཚེ་དང་ལྡན་པ་ཁྱོད་ཉོན་ཅིག་། ཚེ་དང་ལྡན་པ་ཁྱོད་ཉོན་ཅིག་། མ་བྱིན་པར་ལེན་པ་ནི་བཅོམ་ལྡན་འདས་ཀྱིས་༄༡༡༢བ་རྣམ་གྲངས་དུ་མས་སྨད་དོ་༎ མ་བྱིན་པར་ལེན་པ་སྤངས་པ་ནི་བསྟོད་དོ་༎ བཀུར་རོ་༎ བསྔགས་སོ་༎
K01bhikavau:503	 tīvraś cetasa ārakṣāsmṛtyapramāde yogaḥ karaṇīyaḥ /  kaccid evaṃrūpaṃ sthānaṃ nādhyāpatsyase /  nādhyāpatsye /	T08D4118:112a-20	དེང་ཕྱིན་ཆད་ཁྱོད་སྤྱོད་པ་མ་ཡིན་པ་དང་། བྱ་བ་མ་ཡིན་པ་དང་༏་སྤྱད་པ་མ་ཡིན་པ་སྤང་བདེ་ལ་དྲན་པ་དང་བག་ཡོད་པས་སེམས་ཤིན་ཏུ་བསྲུང་བར་བརྩོན་པར་གྱིས་ཤིག་། ཇི་ལྟར་གནས་འདི་ལྟ་བུ་ལ་མི་སྤྱོད་དམ་། དེས་མི་སྤྱོད་ཅེས་བརྗོད་པར་བྱའོ་༎
K01bhikavau:509	 uktaṃ bhagavatā /	T08D4118:112b-5	ཚེ་དང་ལྡན་པ་བཅོམ་ལྡན་འདས་དེ་བཞིན་གཤེགས་པ་དགྲ་བཅོམ་པ་ཡང་དག་པར་རྫོགས་པའི་སངས་རྒྱས་མཁྱེན་ཅིང་གཟིགས་པ་དེས་།
K01bhikavau:508	 stutā stomitā varṇitā praśastā adyāgreṇa te evannāmike steyacittayāntatas tilatuṣam api parakīyan nādātavyaṃ kaḥ punar vādaḥ pañcamāsikaṃ vā uttarapañcamāsikaṃ vā	T08D4118:112b-4	ཚེ་དང་ལྡན་པ་ཁྱོད་དེང་ཕྱིན་ཆད་རྐུ་སེམས་ཀྱིས་ཐ་ན་གཞན་གྱི་ཏིལ་གྱི་ཕུབ་མ་ཡང་མ་བྱིན་པར་མི་བླང་ན་མ་ཤ་ཀ་ལྔ་འམ་མ་ཤ་ཀ་ལྔ་ལས་ལྷག་པ་ལྟ་སྨོས་ཀྱང་ཅི་དགོས་།
K01bhikavau:510	 yā punar bhikṣuṇī grāmagataṃ vā araṇyagataṃ vā pareṣām adattaṃ steyasaṃkhyātam ādadīta	T08D4118:112b-6	ཡང་དགེ་སློང་གང་གཞན་དག་གི་གྲོང་ན་འདུག་པའམ་། དགོན་པ་ན་འདུག་པ་མ་བྱིན་པ་རྐུ་བའི་གྲངས་སུ་གཏོགས་པ་བླངས་ན་།
K01bhikavau:511	 yadrūpeṇādattādānena rājā vainaṃ gṛhītvā rājamātro vā hanyād vā badhnīyād vā pravāsayed	T08D4118:112b-8	ཇི་ཙམ་མ་བྱིན་པར་བླངས་པས་དེ་རྒྱལ་པོ་འམ་བློན་པོ་ཆེན་པོས་བཟུང་ནས་དེ་ལ་འདི་སྐད་ཅེས་།
K01bhikavau:513	 evaṃrūpaṃ bhikṣuṇī sthānam adhyāpadya sahādhyāpattyābhikṣuṇī bhavaty aśramaṇī aśākyaputrīyā pūrvavad yāvat smṛtyapramāde yogaḥ karaṇīyaḥ /	T08D4118:112b-15	དགེ་སྦྱོང་དུ་མི་རུང་། ཤའཀྱའི་སྲས་ཀྱང་མི་རུང་། དགེ་སློང་གི་དངོས་པོ་ལས་ཉམས་པར་འགྱུར་ཏེ་། དེའི་དགེ་སྦྱོང་གི་ཚུལ་ཞིག་པར་འགྱུར་ཞིང་།
K01bhikavau:512	 vā evaṃ cainaṃ vaded dhaṃ bhoḥ puruṣa cauro 'si bālo 'si mūḍho 'si steyo 'sīty	T08D4118:112b-9	ཀྱེ་མི་ཁྱོད་ནི་རྐུན་མའོ་༎ བྱིས་པའོ་༎ བླུན་པའོ་༎ རྐུ་བའོ་ཞེས་ཟེར་ཞིང་གསོད་དམ་འཆིང་ངམ་། སྤྱུགས་ཀྱང་རུང་སྟེ་༏་དགེ་སློང་དེ་ལྟར་མ་བྱིན་པར་ལེན་ན་དགེ་སློང་དེ་ཡང་ཕམ་པར་འགྱུར་པ་ཡིན་གྱི་གནས་པར་མི་བྱའོ་ཞེས་བྱ་བ་ནི་བཀའ་སྩལ་ཏེ་། དགེ་སློང་གིས་གནས་དེ་ལྟ་བུ་བྱས་ན་བྱས་མ་ཐག་ཏུ་དགེ་སློང་དུ་མི་རུང་བར་འགྱུར་།
K01bhikavau:515	 nādhyāpatsye /	T08D4118:112b-25	དེས་མི་སྤྱོད་ཅེས་བརྗོད་པར་བྱའོ་༎
K01bhikavau:514	 kaccid evaṃrūpaṃ sthānaṃ nādhyāpatsyase /	T08D4118:112b-19	ཉམས་པ་། བཅོམ་པ་། ལྟུང་བ་། ཕམ་པར་གྱུར་པ་སྟེ་། དེའི་དགེ་སྦྱོང་གི་ཚུལ་ཕྱིར་བླང་དུ་མེད་པར་འགྱུར་རོ་༎ འདི་ལྟ་སྟེ་དཔེར་ན་ཤིང་ཏ་ལའི་མགོ་བཅད་ནས་སྔོན་པོར་འགྱུར་དུ་མི་རུང་ལ་། འཕེལ་ཞིང་རྒྱས་པ་རང་ཡངས་པར་འགྱུར་དུ་མི་རུང་བ་བཞིན་ནོ་༎ དེང་ཕྱིན་ཆད་ཁྱོད་སྤྱད་པ་མ་ཡིན་པ་དང་། བྱ་བ་མ་ཡིན་པ་དང་། སྤྱད་པ་མ་ཡིན་པ་སྤང་བ་དེ་ལ་དྲན་པ་དང་བག་ཡོད་པས་སེམས་ཤིན་ཏུ་བསྲུང་བར་བརྩོན་པར་གྱིས་ཤིག་། ཇི་ལྟར་གནས་འདི་ལྟ་བུ་ལ་མི་སྤྱོད་དམ་།
K01bhikavau:516	 śṛṇu tvam evaṃnāmike anekaparyāyeṇa bhagavatā prāṇātipāto vigarhitaḥ prāṇātipātād viratiḥ stutā stomitā varṇitā (BhīKaVā 25b1)	T08D4118:112b-26	ཚེ་དང་ལྡན་པ་ཁྱོད་ཉོན་ཅིག་། སྲོག་གཅོད་པ་ནི་བཅོམ་ལྡན་འདས་ཀྱིས་རྣམ་གྲགས་དུ་མས་སྨད་དོ་༎
K01bhikavau:527	 kaccid evaṃrūpaṃ sthānan nādhyāpatsyase /	T08D4118:135a-5	དེས་མི་སྤྱོད་ཅེས་བརྗོད་པར་བྱའོ་༎
K01bhikavau:529	 śṛṇu tvam evannāmike anekaparyāyeṇa bhagavatā mṛṣāvādo vigarhitaḥ /	T08D4118:135a-6	མིང་འདི་ཞེས་བྱ་བ་ཁྱོད་ཉོན་ཅིག་། བརྫུན་དུ་སྨྲ་བ་ནི་བཅོམ་ལྡན་འདས་ཀྱིས་རྣམ་གྲངས་དུ་མས་སྨད་དོ་༎
K01bhikavau:531	 api saṃprajānan mṛṣāvādo na bhāṣitavyaḥ kaḥ punar vādo 'santam asaṃvidyamānam uttaraṃmanuṣyadharmaṃ pralapituṃ /	T08D4118:135a-11	ཤེས་བཞིན་དུ་བརྫུན་དུ་སྨྲ་བར་ཡང་མི་བྱ་ན་། བསམས་བཞིན་དུ་མིའི་ཆོས་བླ་མ་སྨྲ་བ་ལྟ་སྨོས་ཀྱང་ཅི་དགོས་།
K01bhikavau:530	 mṛṣāvādaviratiḥ stutā stomitā varṇitā praśastā adyāgreṇa te evannāmike hāsyaprekṣiṇyā	T08D4118:135a-7	བརྫུན་དུ་སྨྲ་བ་སྤངས་པ་ནི་བསྟོད་དོ་༎ བཀུར་རོ་༎ བསྔགས་སོ་༎ སྙན་པར་བརྗོད་དོ་༎ མིང་འདི་ཞེས་བྱ་བ་ཁྱོད་དེང་ཕྱིན་ཆད་ཐ་ན་བཞད་གད་བྱ་བར་བསམས་ཏེ་།
K01bhikavau:532	 uktañ ca bhagavatā yā punar bhikṣuṇī anabhijānantī aparijānantī asantam asaṃvidyamānam	T08D4118:135a-13	མིང་འདི་ཞེས་བྱ་བ་བཅོམ་ལྡན་འདས་དེ་བཞིན་གཤེགས་པ་དགྲ་བཅོམ་པ་ཡང་དག་པར་རྫོགས་པའི་སངས་རྒྱས་མཁྱེན་ཅིང་གཟིགས་པ་དེས་ཡང་དགེ་སློང་མ་གང་མངོན་བར་མི་ཤེས་ཤིང་ཡོངས་སུ་མི་ཤེས་ལ་།
K01bhikavau:533	 uttaraṃmanuṣyadharmam alamāryaviśeṣādhigamaṃ jñānaṃ vā darśanaṃ vā sparśavihāratāṃ	T08D4118:135a-14	མིའི་ཆོས་བླ་མ་མཐའ་དང་། འཕགས་པ་དང་། བྱེ་བྲག་ཐོབ་པ་དང་། ཤེས་པ་དང་། མཐོང་བ་དང་། རེག་པར་སྤྱོད་པ་མེད་ལ་མེད་བཞིན་དུ་འདི་ཤེས་སོ་༎ འདི་མཐོང་ངོ་ཞེས་ཁས་འཆེས་པ་ལས་། དེ་ལྟུང་བ་བྱུང་བ་རྣམ་པར་དག་པར་འདོད་ནས་དུས་གཞན་ཞིག་ན་དྲིས་ཀྱང་རུང་མ་དྲིས་ཀྱང་རུང་འདི་སྐད་ཅེས་འཕགས་མ་དག་བདག་གིས་ནི་མི་ཤེས་པར་ཤེས་སོ་ཞེས་སྨྲས་། མ་མཐོང་བར་མཐོང་ངོ་ཞེས་སྨྲས་ཏེ་། གསོ་བ་གསོག་བརྫུན་དུ་སྨྲས་སོ་ཞེས་ཟེར་ན་མངོན་པའི་ང་རྒྱལ་མ་གཏོགས་ཏེ་། དགེ་སློང་མ་དེ་ཡང་ཕམ་པར་གྱུར་པ་ཡིན་གྱིས་གནས་པར་མི་བྱའོ་ཞེས་བྱ་བ་འདི་བཀའ་སྩལ་ཏེ་༏
K01bhikavau:536	 kiṃ paśyāmi devān paśyami nāgān yakṣān garuḍān gandharvān kinnarān mahoragān piśācān kaṭapūtanān paśyāmi /	T08D4118:135a-23	ཅི་ཞིག་མཐོང་ཞེ་ན་། ལྷ་རྣམས་མཐོང་ངོ་༎
K01bhikavau:534	 vā pratijānīyād idaṃ jānāmīdaṃ paśyāmi kiṃ jānāmi duḥkhaṃ jānāmi /	T08D4118:135a-20	ཅི་ཞིག་ཤེས་ཤེ་ན་། སྡུག་བསྔལ་ཤེས་སོ་༎ ཀུན་འབྱུང་བ་དང་། འགོག་པ་དང་། ལམ་ཤེས་སོ་༎
K01bhikavau:527	 kaccid evaṃrūpaṃ sthānan nādhyāpatsyase /	T08D4118:113a-25	དེས་མི་སྤྱོད་ཅེས་བརྗོད་པར་བྱའོ་༎
K01bhikavau:529	 śṛṇu tvam evannāmike anekaparyāyeṇa bhagavatā mṛṣāvādo vigarhitaḥ /	T08D4118:113a-26	ཚེ་དང་ལྡན་པ་ཁྱོད་ཉོན་ཅིག་། བརྫུན་དུ་སྨྲ་བ་ནི་བཅོམ་ལྡན་འདས་ཀྱིས་རྣམ་གྲངས་དུ་མས་སྨད་དོ་༎
K01bhikavau:531	 api saṃprajānan mṛṣāvādo na bhāṣitavyaḥ kaḥ punar vādo 'santam asaṃvidyamānam uttaraṃmanuṣyadharmaṃ pralapituṃ /	T08D4118:113b-1	བསམས་བཞིན་དུ་མིའི་ཆོས་བླ་མ་སྨྲ་བ་ལྟ་སྨོས་ཀྱང་ཅི་དགོས་།
K01bhikavau:530	 mṛṣāvādaviratiḥ stutā stomitā varṇitā praśastā adyāgreṇa te evannāmike hāsyaprekṣiṇyā	T08D4118:113a-27	བརྫུན་དུ་སྨྲ་བ་སྤངས་པ་ནི་བསྟོད་དོ་༎ བཀུར་རོ་༎ བསྔགས་སོ་༎ ཚེ་དང་ལྡན་པ་ཁྱོད་དེང་ཕྱིན་ཆད་ཐ་ན་བཞད་གད་བྱ་བར་༄༡༡༣བ་བསམས་ཏེ་ཤེས་བཞིན་དུ་བརྫུན་དུ་སྨྲ་བར་ཡང་མི་བྱ་ན་།
K01bhikavau:532	 uktañ ca bhagavatā yā punar bhikṣuṇī anabhijānantī aparijānantī asantam asaṃvidyamānam	T08D4118:113b-2	ཚེ་དང་ལྡན་པ་བཅོམ་ལྡན་འདས་དེ་བཞིན་གཤེགས་པ་དགྲ་བཅོམ་པ་ཡང་དག་པར་རྫོགས་པའི་སངས་རྒྱས་མཁྱེན་ཅིང་གཟིགས་པ་དེས་། ཡང་དགེ་སློང་གང་མངོན་པར་མི་ཤེས་ཤིང་ཡོངས་སུ་མི་ཤེས་ལ་མིའི་ཆོས་བླ་མ་མཐའ་དང་། འཕགས་པ་དང་། བྱེ་བྲག་ཐོབ་པ་དང་། ཤེས་པ་དང་། མཐོང་བ་དང་། རེག་པར་སྤྱོད་པ་མེད་ལ་། མེད་བཞིན་དུ་འདི་ཤེས་སོ་༎ འདི་མཐོང་ངོ་ཞེས་ཁས་འཆེས་པ་ལས་དེ་ལྟུང་བ་བྱུང་བ་རྣམ་པར་དག་པར་འདོད་ནས་དུས་གཞན་ཞིག་ན་དྲིས་ཀྱང་རུང་མ་དྲིས་ཀྱང་རུང་འདི་སྐད་ཅེས་ཚེ་དང་ལྡན་པ་དག་བདག་གིས་ནི་མི་ཤེས་པར་ཤེས་སོ་ཞེས་སྨྲས་།
K01bhikavau:533	 uttaraṃmanuṣyadharmam alamāryaviśeṣādhigamaṃ jñānaṃ vā darśanaṃ vā sparśavihāratāṃ	T08D4118:113b-6	མ་མཐོང་བར་མཐོང་ངོ་ཞེས་སྨྲས་ཏེ་། གསོ་བ་གསོག་བརྫུན་དུ་སྨྲས་སོ་ཞེས་ཟེར་ན་མངོན་པའི་ང་རྒྱལ་མ་གཏོགས་ཏེ་། དགེ་སློང་དེ་ཡང་ཕམ་པར་གྱུར་པ་ཡིན་གྱི་གནས་པར་མི་བྱའོ་ཞེས་བྱ་བ་འདི་བཀའ་སྩལ་ཏེ་།
K01bhikavau:534	 vā pratijānīyād idaṃ jānāmīdaṃ paśyāmi kiṃ jānāmi duḥkhaṃ jānāmi /  kiṃ paśyāmi devān paśyami nāgān yakṣān garuḍān gandharvān kinnarān mahoragān piśācān kaṭapūtanān paśyāmi /	T08D4118:113b-9	ཅི་ཞིག་ཤེས་ཤེ་ན་། སྡུག་བསྔལ་ཤེས་སོ་༎ ཀུན་འབྱུང་བ་དང་། འགོག་པ་དང་། ལམ་ཤེས་སོ་༎ ཅི་ཞིག་མཐོང་ཞེ་ན་།
K01bhikavau:549	 pratikūlasaṃjñāyāḥ sarvaloke 'nabhiratisaṃjñāyā ādīnavasaṃjñāyāḥ prahāṇasaṃjñāyā  virāgasaṃjñāyā maraṇasaṃjñāyā nirodhasaṃjñāyāḥ /  aśubhasaṃjñāyā vinīlakasaṃjñāyā vipūyakasaṃjñāyā vipaṭumakasaṃjñāyā vyādhmātakasaṃjñāyā  vikhyāditakasaṃjñāyā vilohitakasaṃjñāyā vikṣiptakasaṃjñāyā asthisaṃjñāyāḥ śūnyatāpratyavekṣaṇasaṃjñāyāḥ /  alābhy eva saṃl lābhy aham asmi prathamasya dhyānasya dvitīyasya tṛtīyasya caturthasya maitryāḥ karuṇāyā muditāyā upekṣāyā /	T08D4118:136b-2	མ་ཐོབ་བཞིན་དུ་བདག་གིས་བསམ་གཏན་དང་པོ་དང་། གཉིས་པ་དང་། གསུམ་པ་དང་། བཞི་པ་དང་། བྱམས་པ་དང་། སྙིང་རྗེ་དང་། དགའ་བ་དང་། བཏང་སྙོམས་དང་། ནམ་མཁའ་མཐའ་ཡས་སྐྱེ་མཆེད་དང་། རྣམ་ཤེས་མཐའ་ཡས་སྐྱེ་མཆེད་དང་།
K01bhikavau:554	 ākāśānantyāyatanasya vijñānānantyāyatanasya ākiñcanyāyatanasya naivasaṃjñānāsaṃjñāyatanasya  alābhy eva saṃl lābhy aham asmi śrotaāpattiphalasya sakṛdāgāmiphalasya anāgāmiphalasya	T08D4118:136b-3	ཅི་ཡང་མེད་པའི་སྐྱེ་མཆེད་དང་༏་འདུ་ཤེས་མེད་འདུ་ཤེས་མེད་མིན་སྐྱེ་མཆེད་དང་། རྒྱུན་ཏུ་ཞུགས་པའི་འབྲས་བུ་དང་། ལན་ཅིག་ཕྱིར་འོང་བའི་འབྲས་བུ་དང་། ཕྱིར་མི་འོང་བའི་འབྲས་བུ་དང་། དགྲ་བཅོམ་པ་ཉིད་ཀྱི་འབྲས་བུ་དང་། རྫུ་འཕྲུལ་གྱི་ཡུལ་དང་། ལྷའི་རྣ་བ་དང་། སེམས་ཀྱི་རྣམ་གྲངས་དང་། སྔོན་གྱི་གནས་དང་། འཆི་འཕོ་དང་སྐྱེ་བ་དང་། ཟག་པ་ཟད་པ་ཐོབ་བོ་༎
K01bhikavau:557	 aham asmy aṣṭavimokṣadhyāyī ubhayatobhāgavimukta ity	T08D4118:136b-5	བདག་ནི་དགྲ་བཅོམ་པ་རྣམ་བར་ཐར་པ་བརྒྱད་ལ་བསམ་གཏན་པ་དང་། གཉི་གའི་ཆ་ལས་རྣམ་པར་གྲོལ་བ་ཡིན་ནོ་ཞེས་བྱ་བ་སྟེ་།
K01bhikavau:558	 evaṃrūpaṃ bhikṣuṇī sthānam adhyāpadya sahādhyāpattyā abhikṣuṇī bhavaty aśramaṇī aśākyaputrīyā	T08D4118:136b-6	དགེ་སློང་མས་གནས་འདི་ལྟ་བུ་བྱས་ན་བྱས་མ་ཐག་ཏུ་དགེ་སློང་མར་མི་རུང་བར་འགྱུར་། དགེ་སྦྱོར་དུ་མི་རུང་། ཤའཀྱའི་སྲས་ཀྱི་ར་མི་རུང་།
K01bhikavau:559	 dhvasyate bhikṣuṇībhāvād dhatam asyā bhavati śrāmaṇyaṃ dhvastaṃ mathitaṃ patitaṃ	T08D4118:136b-9	དགེ་སློང་མའི་དངོས་པོ་ལས་ཉམས་བར་འགྱུར་ཏེ་། དེའི་དགེ་སྦྱོང་གི་ཚུལ་ཞིག་པར་འགྱུར་ཞིང་། ཉམས་པ་། བཅོམ་པ་། ལྟུང་བ་། ཕམ་པར་འགྱུར་ཏེ་།
K01bhikavau:560	 parājitam apratyuddhāryam asyā bhavati śrāmaṇyaṃ tadyathā tālo mastakāc chinno 'bhavyo	T08D4118:136b-13	དེའི་དགེ་སྦྱོང་གི་ཚུལ་ཕྱིར་བླང་དུ་མེད་པར་འགྱུར་རོ་༎ འདི་ལྟ་སྟེ་དཔེར་ན་ཤིང་ཏ་ལའི་མགོ་བཅད་ན་སྔོན་པོར་འགྱུར་དུ་མི་རུང་ལ་།
K01bhikavau:564	 apratyuddhāryam asyā bhavati śrāmaṇyaṃ tatra te 'dyāgreṇa anadhyācāre adhyācāravairamaṇyāṃ  tīvraś cetasa ārakṣāsmṛtyapramāde yogaḥ karaṇīyaḥ /	T08D4118:136b-16	དེང་ཕྱིན་ཆད་ཁྱོད་ཀྱིས་སྤྱད་པ་མ་ཡིན་པ་དང་། བྱ་བ་མ་ཡིན་པ་དང་། སྤྱད་པ་མ་ཡིན་པ་སྤང་བ་དེ་ལ་དྲན་པ་དང་བག་ཡོད་པས་སེམས་ཤིན་ཏུ་བསྲུང་བར་བརྩོན་པར་གྱིས་ཤིག་། ཇི་ལྟར་གནས་འདི་ལྟ་བུ་ལ་མི་སྤྱོད་དམ་།
K01bhikavau:614	 nādhyāpatsye /  śṛṇu tvam evannāmike aṣṭāv ime tena bhagavatā jānatā paśyatā tathāgatenārhatā samyaksaṃbuddhenaivaṃ  pravrajitopasaṃpannāyā bhikṣuṇyā gurudharmāḥ prajñaptā āvaraṇayānatikramaṇāya yatra	T08D4118:139a-0	མིང་འདི་ཞེས་བྱ་བ་ཁྱོད་ཉོན་ཅིག་། བརྒྱད་པོ་འདི་དག་ནི་བཅོམ་ལྡན་འདས་དེ་བཞིན་གཤེགས་པ་དགྲ་བཅོམ་པ་ཡང་དག་པར་རྫོགས་པའི་སངས་རྒྱས་མཁྱེན་ཅིང་གཟིགས་པ་དེས་དགག་༄༡༣༩ཨ་༌་༎ པ་དང་མི་འདའ་བར་བྱ་བའི་ཕྱིར་དེ་ལྟར་རབ་ཏུ་བྱུང་བ་དང་བསྙེན་པར་རྫོགས་པ་དགེ་སློང་མའི་ལྕི་བའི་ཆོས་སུ་བཅས་པ་སྟེ་།
K01bhikavau:617	 mātṛgrāmeṇa yāvajjīvaṃ śikṣā karaṇīyā /	T08D4118:139a-2	དེ་དག་ལ་དགེ་སློང་མས་ཇི་སྲིད་འཚོའི་བར་དུ་བསླབ་བར་བྱའོ་༎
K01bhikavau:618	 katame aṣṭau	T08D4118:139a-3	བརྒྱད་གང་ཞེ་ན་།
K01bhikavau:619	 bhikṣubhyaḥ sakāśād evaṃnāmike mātṛgrāmeṇa pravrajyā upasaṃpad bhikṣuṇībhāvaḥ pratikāṃkṣitavya (BhīKaVā 30a1)  ayam evannāmike bhagavatā mātṛgrāmasya prathamo gurudharmaḥ prajñaptaḥ /	T08D4118:139a-4	མིང་འདི་ཞེས་བྱ་བ་དགེ་སློང་མས་དགེ་སློང་རྣམས་ལས་རབ་ཏུ་འབྱུང་བ་དང་བསྙེན་པར་རྫོགས་པ་དགེ་སློང་མའི་དངོས་པོ་ཡོངས་སུ་བཙལ་བར་བྱ་བ་འདི་ནི་བཅོམ་ལྡན་འདས་ཀྱིས་དགག་པ་དང་མི་འདའ་བར་བྱ་བའི་ཕྱིར་དགེ་སློང་མའི་ལྕི་བའི་ཆོས་སུ་བཅས་པ་དང་པོ་སྟེ་།
K01bhikavau:621	 āvaraṇāyānatikramaṇāya yatra mātṛgrāmeṇa yāvajjīvaṃ śikṣā karaṇīyā /	T08D4118:139a-6	དེ་ལ་དགེ་སློང་མས་ཇི་སྲིད་འཚོའི་བར་དུ་བསླབ་པར་བྱའོ་༎
K01bhikavau:622	 bhikṣubhyaḥ sakāśād bhikṣuṇyā anvardhamāsam avavādānuśāsanī paryeṣitavyā /  ayam evannāmike bhagavatā mātṛgrāmasya dvitīyo gurudharmaḥ prajñapta āvaraṇāyānatikramaṇāya yatra mātṛgrāmeṇa yāvajjīvaṃ śikṣā karaṇīyā /	T08D4118:139a-7	མིང་འདི་ཞེས་བྱ་བ་དགེ་སློང་མས་དགེ་སློང་རྣམས་ལས་ཟླ་བ་ཕྱེད་ཕྱེད་ཅིང་གདམས་ངག་དང་རྗེས་སུ་བསྟན་པ་ཡོངས་སུ་བཙལ་བར་བྱ་བ་འདི་ནི་བཅོམ་ལྡན་འདས་ཀྱིས་དགག་པ་དང་མི་འདའ་བར་བྱ་བའི་ཕྱིར་དགེ་སློང་མའི་ལྕི་བའི་ཆོས་སུ་བཅས་པ་གཉིས་པ་སྟེ་།
K01bhikavau:624	 na bhikṣuṇyā abhikṣuke āvāse varṣā upagantavyā ayam evaṃnāmike bhagavatā mātṛgrāmasya tṛtīyo gurudharmaḥ prajñaptaḥ /	T08D4118:139a-9	དེ་ལ་དགེ་སློང་མས་ཇི་སྲིད་འཚོའི་བར་དུ་བསླབ་པར་བྱའོ་༎ མིང་འདི་ཞེས་བྱ་བ་དགེ་སློང་མས་དགེ་སློང་མེད་པའི་གནས་སུ་དབྱར་གནས་པར་ཁས་བླང་བར་མི་བྱ་བ་འདི་ནི་བཅོམ་ལྡན་འདས་ཀྱིས་དགག་པ་དང་མི་འདའ་བར་བྱ་བའི་ཕྱིར་དགེ་སློང་མའི་ལྕི་བའི་ཆོས་སུ་བཅས་པ་གསུམ་པ་སྟེ་། དེ་ལ་དགེ་སློང་མས་ཇི་སྲིད་འཚོའི་བར་དུ་བསླབ་པར་བྱའོ་༎ ཕྱིར་དགེ་སློང་མའི་ལྕི་བར་ཆོས་སུ་བཅས་པ་བཞི་པ་སྟེ་༏
K01bhikavau:625	 āvaraṇāyānatikramaṇāya yatra mātṛgrāmeṇa yāvajjīvaṃ śikṣā karaṇīyā /	T08D4118:139a-14	དེ་ལ་དགེ་སློང་མས་ཇི་སྲིད་འཚོའི་བར་དུ་བསླབ་བར་བྱའོ་༎
K01bhikavau:626	 varṣoṣitayā bhikṣuṇyā ubhayasaṃghas tribhiḥ sthānaiḥ pravārayitavyaḥ /	T08D4118:139a-15	མིང་འདི་ཞེས་བྱ་བ་དགེ་སློང་མས་དགེ་སློང་ལ་ཚུལ་ཁྲིམས་ཉམས་པའམ་།
K01bhikavau:628	 ayaṃ evannāmike bhagavatā mātṛgrāmasya caturtho gurudharmaḥ prajñapta /  āvaraṇāyānatikramaṇāya yatra mātṛgrāmeṇa yāvajjīvaṃ śikṣā karaṇīyā /	T08D4118:139a-17	ཆོ་ག་ཉམས་པའམ་། འཚོ་བ་ཉམས་པས་གླེང་བར་མི་བྱ་། དྲན་པར་མི་བྱ་།
K01bhikavau:630	 na bhikṣuṇyā bhikṣuś codayitavyaḥ (BhīKaVā 30b1)	T08D4118:139a-20	དགེ་སློང་མས་དགེ་སློང་ལ་ཚུལ་ཁྲིམས་ཉམས་པའམ་།
K01bhikavau:632	 āvṛtaṃ bhikṣuṇyā bhikṣuñ codayituṃ smārayituṃ śīlavipattyā dṛṣṭivipattyā ājīvavipattyā /  anāvṛtaṃ bhikṣor bhikṣuṇīṃ codayituṃ smārayituṃ śīlavipattyā dṛṣṭivipattyā ājīvavipattyā	T08D4118:139a-21	ལྟ་བ་ཉམས་པའམ་། ཆོ་ག་ཉམས་པའམ་། འཚོ་བ་ཉམས་པས་གླེང་བར་བྱ་བ་དང་། དྲན་པར་བྱ་བ་བཀག་ལ་། དགེ་སློང་གིས་དགེ་སློང་མ་ལ་ཚུལ་ཁྲིམས་ཉམས་པའམ་། ལྟ་བ་ཉམ་པའམ་།
K01bhikavau:634	 ayam evannāmike bhagavatā mātṛgrāmasya pañcamo gurudharmaḥ prajñapta āvaraṇāyānatikramaṇāya  yatra mātṛgrāmeṇa yāvajjīvaṃ śikṣā karaṇīyā /	T08D4118:139a-26	ཆོ་ག་ཉམས་པའམ་། ལྟ་བ་ཉམས་པས་གླེང་བར་བྱ་བ་༄༡༣༩བ་དང་༏་དྲན་པར་བྱ་བ་བཀག་པ་འདི་ནི་བཅོམ་ལྡན་འདས་ཀྱིས་དགག་པ་དང་མི་འདའ་བར་བྱ་བའི་ཕྱིར་དགེ་སློང་མའི་ལྕི་བའི་ཆོས་སུ་བཅས་པ་ལྔ་པ་སྟེ་། དེ་ལ་དགེ་སློང་མས་ཇི་སྲིད་འཚོའི་བར་དུ་བསླབ་པར་བྱའོ་༎
K01bhikavau:636	 na bhikṣuṇyā bhikṣur ākroṣṭavyo na roṣayitavya āvṛtam bhikṣuṇyā bhikṣum ākroṣṭuṃ	T08D4118:139b-2	མིང་འདི་ཞེས་བྱ་བ་དགེ་སློང་མས་དགེ་སློང་ལ་གཤེ་བར་མི་བྱ་བ་དང་། ཁྲོ་བར་མི་བྱ་བ་དང་། སྤྱོ་བར་མི་བྱ་བ་སྟེ་།
K01bhikavau:637	 roṣayituṃ paribhāṣayitum ayam evaṃnāmike bhagavatā mātṛgrāmasya ṣaṣṭo gurudharmaḥ  prajñapta āvaraṇāyānatikramaṇāya yatra mātṛgrāmeṇa yāvajjīvaṃ śikṣā karaṇīyā /  gurudharmādhyāpannayā bhikṣuṇyā ubhayasaṃghe anvardhamāsaṃ mānāpyañ caritavyam ayam  evannāmike bhagavatā mātṛgrāmasya saptamo gurudharmaḥ prajñapta āvaraṇāyānatikramaṇāya  yatra mātṛgrāmeṇa (BhīKaVā 31a1)	T08D4118:139b-3	དགེ་སློང་མས་དགེ་སློང་ལ་གཤེ་བ་དང་། ཁྲོ་བ་དང་། སྤྱོ་བ་བཀག་པ་འདི་ནི་བཅོམ་ལྡན་འདས་ཀྱིས་དགག་པ་དང་མི་འདའ་བར་བྱ་བའི་ཕྱིར་དགེ་སློང་མའི་ལྕེ་བའི་ཆོས་སུ་བཅས་པ་དྲུག་པ་སྟེ་། དེ་ལ་དགེ་སློང་མས་ཇི་སྲིད་འཚོའི་བར་དུ་བསླབ་བར་བྱའོ་༎
K01bhikavau:643	 varṣaśatopasaṃpannayā bhikṣuṇyā tad ahar upasaṃpannasya bhikṣor abhivādanavandanapratyutthānāñjalisāmīcīkarma	T08D4118:139b-5	མིང་འདི་ཞེས་བྱ་བ་དགེ་སློང་མ་བསྙེན་པར་རྫོགས་ནས་ལོ་བརྒྱ་ལོན་པས་ཀྱང་དགེ་སློང་དེ་རིང་བསྙེན་པར་རྫོགས་པ་ལ་ཡང་གུས་པར་སྨྲ་བ་དང་། ཕྱག་བྱ་བ་དང་༎ དང་པོར་ལྡང་བ་དང་། ཐལ་མོ་སྦྱར་བ་དང་།
K01bhikavau:644	 kartavyam ayam evannāmike bhagavatā mātṛgrāmasyāṣṭamo gurudharmaḥ prajñapta āvaraṇāyānatikramaṇāya	T08D4118:139b-6	གུས་པར་བྱ་བའི་ལས་བྱ་བ་འདི་ནི་བཅོམ་ལྡན་འདས་ཀྱིས་དགག་པ་དང་མི་འདའ་བར་བྱ་བའི་ཕྱིར་དགེ་སློང་མའི་ལྕི་བའི་ཆོས་སུ་བཅས་པ་བདུན་པ་སྟེ་། དེ་ལ་དགེ་སློང་མས་ཇི་སྲིད་འཚོའི་བར་དུ་བསླབ་པར་བྱའོ་༎ མིང་འདི་ཞེས་བྱ་བ་དགེ་སློང་མ་ལྕི་བའི་ཆོས་བྱས་པས་གཉི་གའི་དགེ་འདུན་ལ་ཟླ་བ་ཕྱེད་དུ་མགུ་བར་བྱ་བ་སྤྱད་པར་བྱ་བ་འདི་ནི་བཅོམ་ལྡན་འདས་ཀྱིས་དགག་པར་བྱ་བ་དང་མི་འདའ་བར་བྱ་བའི་ཕྱིར་དགེ་སློང་མའི་ལྕི་བའི་ཆོས་སུ་བཅས་པ་བརྒྱད་པ་སྟེ་། དེ་ལ་དགེ་སློང་མས་ཇི་སྲིད་འཚོའི་བར་དུ་བསླབ་པར་བྱའོ་༎
K01bhikavau:646	 kaccid etān aṣṭau gurudharmān samādāya vartase / varte /	T08D4118:139b-11	ཇི་ལྟར་ལྕི་བའི་ཆོས་བརྒྱད་པོ་འདི་དག་ཀྱང་ཡང་དག་པར་བླངས་ཏེ་སྤྱོད་དམ་།
K01bhikavau:647	 śṛṇu tvam evannāmike catvāra ime tena bhagavatā pūrvavad yāvat samyaksaṃbuddhenaivaṃ pravrajitopasaṃpannāyā bhikṣuṇyāḥ śramaṇakārakāḥ /	T08D4118:139b-12	དེས་སྤྱོད་ཅེས་བརྗོད་པར་བྱའོ་༎ དེ་ནི་ལྕི་བའི་ཆོས་རྣམས་བརྗོད་པའོ་༎ དེའི་འོག་ཏུ་དགེ་སྦྱོང་དུ་བྱེད་པའི་ཆོས་རྣམས་བརྗོད་པར་བྱ་སྟེ་། མིང་འདི་ཞེས་བྱ་བ་ཁྱོད་ཉོན་ཅིག་། བཞི་པོ་འདི་དག་ནི་བཅོམ་ལྡན་འདས་དེ་བཞིན་གཤེགས་པ་དགྲ་བཅོམ་པ་ཡང་དག་པར་རྫོགས་པའི་སངས་རྒྱས་མཁྱེན་ཅིང་གཟིགས་པ་དེས་དེ་ལྟར་རབ་ཏུ་བྱུང་བ་དང་། བསྙེན་པར་རྫོགས་པའི་དགེ་སློབ་མའི་དགེ་སྦྱོང་དུ་བྱེད་པའི་ཆོས་སུ་གསུངས་ཏེ་།
K01bhikavau:648	 katame catvāraḥ /	T08D4118:139b-16	བཞི་གང་ཞེ་ན་།
K01bhikavau:649	 adyāgreṇa evannāmike ākruṣṭayā na pratyākroṣṭavyaṃ /	T08D4118:140a-0	མིང་འདི་ཞེས་བྱ་བ་ཁྱོད་ཀྱིས་དེང་ཕྱིན་ཆད་གཤེ་ཡང་སླར་མི་གཤེ་བར་བྱ་བ་དང་། ཁྲོས་ཀྱང་སླར་མི་ཁྲོ་བར་བྱ་བ་དང་། ༄༡༤༠ཨ་༌་༎
K01bhikavau:650	 roṣitayā na pratiroṣitavyaṃ /  tāḍitayā na pratitāḍitavyaṃ bhaṇḍitayā na pratibhaṇḍitavyaṃ //	T08D4118:140a-1	བརྡེགས་ཀྱང་སླར་མི་བརྡེག་པར་བྱ་བ་དང་། མཚང་བྲུས་ཀྱང་སླར་མཚང་མི་འབྲུ་བར་བྱ་བའོ་༎
K01bhikavau:653	 aho vatāhaṃ labheya svākhyāte dharmavinaye pravrajyām upasaṃpadaṃ bhikṣuṇībhāvam iti /	T08D4118:140a-3	དེས་སྤྱོད་ཅེས་བརྗོད་དཔར་བྱའོ་༎ དེ་ནི་དགེ་སྦྱོང་དུ་བྱེད་པའི་ཆོས་རྣམས་བརྗོད་པའོ་༎
K01bhikavau:655	 pravrajitopasaṃpannā pratirūpayā upādhyāyikayā pratirūpābhyām ācāryābhyāṃ samagreṇobhayasaṃghena jñapticaturthena karmaṇā akopyenāsthāpanārheṇa	T08D4118:140a-7	འོས་པ་དང་། སློབ་དཔོན་དུ་འོས་པ་གཉིས་དང་། དགེ་འདུན་མཐུན་པ་དང་། གསོལ་བ་དང་བཞིའི་ལས་མི་ག-ཡོ་བ་གཞག་པར་མི་འོས་པས་རབ་ཏུ་བྱུང་ཞིང་བསྙེན་པར་རྫོགས་སོ་༎ དེ་ནི་མཆོག་ཏུ་འདོད་པར་བྱ་བ་ཡང་དག་པ་ཉིད་ཀྱིས་རྫོགས་པ་ཉིད་བརྗོད་པའོ་༎ དེའི་འོག་ཏུ་ཚུལ་ཁྲིམས་ཀྱིས་མཉམ་པར་གྱུར་པ་ཉིད་སྒྲུབ་པ་ལ་ངེས་པར་སྦྱར་བ་བརྗོད་པར་བྱ་སྟེ་།
K01bhikavau:656	 yatra varṣaśatopasaṃpannayā bhikṣuṇyā śikṣāyāṃ śikṣitavyaṃ /  tatra tad ahar upasaṃpannayā yatra tad ahar upasaṃpannayā tatra varṣaśatopasaṃpannayā iti	T08D4118:140a-10	མིང་འདི་ཞེས་བྱ་བ་ཁྱོད་ཉོན་ཅིག་། བསྙེན་པར་རྫོགས་ནས་ལོ་བརྒྱ་ལོན་པའི་དགེ་སློང་མས་བསླབ་པ་གང་ལ་བསླབ་པར་བྱ་བ་དེ་ལ་དེ་རིང་བསྙེན་པར་རྫོགས་པས་ཀྱང་བསླབ་བོ་༎ དེ་རིང་བསྙེན་པར་རྫོགས་པའི་དགེ་སློང་མས་བསླབ་པ་གང་ལ་བསླབ་པར་བྱ་བ་དེ་ལ་བསྙེན་པར་རྫོགས་ནས་ལོ་བརྒྱ་ལོན་པས་ཀྱང་བསླབ་བོ་༎
K01bhikavau:658	 yā tu samānaśīlatā samānaśikṣatā samānaprātimokṣasūtroddeśatā sā te 'dyāgreṇārāgayitavyā na virāgayitavyā	T08D4118:140a-12	དེ་ལྟར་ན་ཚུལ་ཁྲིམས་ཉིད་ཀྱིས་མཉམ་པ་དང་། བསླབ་པ་ཉིད་ཀྱིས་མཉམ་པ་དང་། སོ་སོར་ཐར་པའི་མདོ་འདོན་པ་ཉིད་ཀྱིས་མཉམ་པ་སྟེ་། ཁྱོད་ཀྱིས་དེང་ཕྱིན་ཆད་བསྒྲུབ་པར་བྱའི་མི་སྒྲུབ་པར་མི་བྱའོ་༎ དེ་ནི་ཚུལ་ཁྲིམས་ཀྱིས་མཉམ་པར་གྱུར་པ་ཉིད་བསྒྲུབ་པ་ལ་ངེས་པར་སྦྱར་བའོ་༎ དེའི་འོག་ཏུ་ཚུལ་དང་འབྲེལ་བའི་གཟུགས་བརྙན་ལ་ངེས་པར་སྦྱར་བར་བྱ་སྟེ་།
K01bhikavau:659	 adyāgreṇa te evaṃnāmike upādhyāyikāyā antike mātṛsaṃjñā upasthāpayitavyā upādhyāyikayā api tavāntike duhitṛsaṃjñā upasthāpayitavyā	T08D4118:140a-16	དེང་ཕྱིན་ཆད་ཁྱོད་ཀྱི་ས་མཁན་མོ་ལ་མའི་འདུ་ཤེས་ཉེ་བར་གཞག་པར་བྱའོ་༎ མཁན་མོས་ཁྱོད་ལ་བུ་མོའི་འདུ་ཤེས་ཉེ་བར་གཞག་པར་བྱའོ་༎
K01bhikavau:660	 adyāgreṇa te upādhyāyikā yāvajjīvaṃ glānā upasthāpayitavyā + + + + + + + .ānād vā upādhyāyikayā tvaṃ glānā upasthāpayitavyā /	T08D4118:140a-18	ཁྱོད་ཀྱིས་དེང་ཕྱིན་ཆད་མཁན་མོ་ལ་ཇི་སྲིད་འཚོའི་བར་དུ་བསྙེན་བཀུར་བྱའོ་༎ མཁན་མོས་ཀྱང་ཁྱོད་ཤིའམ་སོས་ཀྱི་བར་དུ་ནད་ག-ཡོག་བྱའོ་༎
K01bhikavau:88	 na bhikṣuṇyā ānanda bhikṣuś codayitavyaḥ smārayitavyaḥ śīlavipattyā dṛṣṭivipattyā ācāravipattyā ājīvavipattyā /	T08D4118:139a-19	དྲན་པར་མི་བྱ་། དགེ་སློང་མས་དགེ་སློང་ལ་ཚུལ་ཁྲིམས་ཉམས་པའམ་།
K01bhikavau:89	 āvṛtam ānanda bhikṣuṇyā bhikṣuṃ codayituṃ smārayituṃ śīlavipattyā dṛṣṭivipattyā ācāravipattyā	T08D4118:139a-21	ལྟ་བ་ཉམས་པའམ་། ཆོ་ག་ཉམས་པའམ་། འཚོ་བ་ཉམས་པས་གླེང་བར་བྱ་བ་དང་། དྲན་པར་བྱ་བ་བཀག་ལ་། དགེ་སློང་གིས་དགེ་སློང་མ་ལ་ཚུལ་ཁྲིམས་ཉམས་པའམ་། ལྟ་བ་ཉམ་པའམ་།
K01bhikavau:90	 ājīvavipattyā anāvṛtam bhikṣor bhikṣuṇīṃ codayituṃ smārayituṃ śīlavipattyā dṛṣṭivipattyā  ācāravipattyā ājīvavipattyā ity ayaṃ gautami bhagavatā mātṛgrāmasya pañcamo gurudharmaḥ (BhīKaVā 7b1)  prajñapta āvaraṇāyānatikramaṇāya yatra mātṛgrāmeṇa yāvajjīvaṃ śikṣā karaṇīyā /  bhagavān gautamy evam āha /	T08D4118:139a-26	ཆོ་ག་ཉམས་པའམ་། ལྟ་བ་ཉམས་པས་གླེང་བར་བྱ་བ་༄༡༣༩བ་དང་༏་དྲན་པར་བྱ་བ་བཀག་པ་འདི་ནི་བཅོམ་ལྡན་འདས་ཀྱིས་དགག་པ་དང་མི་འདའ་བར་བྱ་བའི་ཕྱིར་དགེ་སློང་མའི་ལྕི་བའི་ཆོས་སུ་བཅས་པ་ལྔ་པ་སྟེ་། དེ་ལ་དགེ་སློང་མས་ཇི་སྲིད་འཚོའི་བར་དུ་བསླབ་པར་བྱའོ་༎
K01bhikavau:94	 na bhikṣuṇyā ānanda bhikṣur ākroṣṭavyo na roṣayitavyo na paribhāṣayitavyaḥ /	T08D4118:139b-2	མིང་འདི་ཞེས་བྱ་བ་དགེ་སློང་མས་དགེ་སློང་ལ་གཤེ་བར་མི་བྱ་བ་དང་། ཁྲོ་བར་མི་བྱ་བ་དང་། སྤྱོ་བར་མི་བྱ་བ་སྟེ་།
K01bhikavau:96	 ity ayaṃ gautami bhagavatā mātṛgrāmasya ṣaṣṭo gurudharmaḥ prajñaptaḥ /  āvaraṇāyānatikramaṇāya yatra mātṛgrāmeṇa yāvajjīvaṃ śikṣā karaṇīyā /  bhagavān gautamy evam āha /	T08D4118:139b-3	དགེ་སློང་མས་དགེ་སློང་ལ་གཤེ་བ་དང་། ཁྲོ་བ་དང་། སྤྱོ་བ་བཀག་པ་འདི་ནི་བཅོམ་ལྡན་འདས་ཀྱིས་དགག་པ་དང་མི་འདའ་བར་བྱ་བའི་ཕྱིར་དགེ་སློང་མའི་ལྕེ་བའི་ཆོས་སུ་བཅས་པ་དྲུག་པ་སྟེ་།
K01bhikavau:99	 gurudharmādhyāpannayā ānanda bhikṣuṇyā ubhayasaṃghe anvardhamāsaṃ mānāpyaṃ caritavyam  ity ayaṃ gautami bhagavatā mātṛgrāmasya saptamo gurudharmaḥ prajñapta āvaraṇāyānatikramaṇāya  yatra mātṛgrāmeṇa yāvajjīvaṃ śikṣā karaṇīyā /  bhagavān gautamy evam āha /	T08D4118:139b-4	དེ་ལ་དགེ་སློང་མས་ཇི་སྲིད་འཚོའི་བར་དུ་བསླབ་བར་བྱའོ་༎
