src_segmentnr	src_original	tgt_segmentnr	tgt_original
K10adbhutdu:12	 [2] athāyuṣmān ānando rājagṛhe nagare sāvadānaṃ piṇḍāya caritvā kṛtabhaktakṛtya paścādbhaktapiṇḍapātapratikrāntaḥ	K10D0208_H0209:170a-5	དེ་ནས་ཚེ་དང་ལྡན་པ་ཀུན་དགའ་བོ་མཉན་ཡོད་ནས་བསོད་སྙོམས་ལས་སླར་འཁོར་ནས་ཟན་ཟོས་ཏེ་ཟས་ཕྱི་མ་སྤངས་ནས་ལྷུང་བཟེད་དང་། ཆོས་གོས་བཞག་སྟེ་རྐང་པ་བཀྲུས་ནས་།
K10adbhutdu:13	 pātracīvaraṃ pratiśamayya pādau prakṣālya yena bhagavāṃs tenopasaṃkrānta upasaṃkramya	K10D0208_H0209:170a-6	བཅོམ་ལྡན་འདས་གན་བ་དེར་སོང་སྟེ་ཕྱིན་ནས་། བཅོམ་ལྡན་འདས་ཀྱི་ཞབས་ལ་མགོ་བོས་ཕྱག་བཙལ་ཏེ་ཕྱོགས་གཅིག་ཏུ་འདུག་གོ་།
K10adbhutdu:14	 bhagavataḥ pādau śirasā vanditvaikānte 'sthāt. ekāntasthita āyuṣmān ānando bhagavantam	K10D0208_H0209:170a-8	ཕྱོགས་གཅིག་ཏུ་འདུག་ནས་བཅོམ་ལྡན་འདས་ལ་ཚེ་དང་ལྡན་པ་ཀུན་དགའ་བོས་འདི་སྐད་ཅེས་གསོལ་ཏོ་༎
K10adbhutdu:15	 idam avocat. ihāhaṃ bhadanta pūrvāhṇe nivāsya pātracīvaram ādāya rājagṛhaṃ piṇḍāya	K10D0208_H0209:170a-9	བཙུན་པ་། འདི་ན་བདག་སྔ་དྲོ་ཤམ་ཐབས་དང་། ཆོས་གོས་བགོས་ཏེ་ལྷུང་བཟེད་ཐོགས་ནས་མཉན་ཡོད་དུ་བསོད་སྙོམས་ལ་མཆིས་ཏེ་།
K10adbhutdu:16	 prāvikṣaṃ. so 'ham adrākṣam rājagṛhe nagare sāvadānaṃ piṇḍāya caramāṇo 'nyatamasmin  pradeśe kūṭāgāram aśītidvāram ulliptāvaliptam ucchṛtadhvajapatākam āmuktapaṭṭadāmakalāpaṃ	K10D0208_H0209:170a-10	བཙུན་པ་། བདག་མཉན་ཡོད་དུ་བསོད་སྙོམས་ལ་མཆིས་པ་ན་ཁང་པ་བརྩེགས་པ་ཆེན་པོ་སླད་ནང་བྱུགས་ཤིང་བྱི་དོར་བགྱིས་པ་། སྒོ་གཏན་ལེགས་པར་སྩལ་པ་། སྐར་ཁུང་བཀུམ་པ་ཞིག་མཐོང་ལགས་སོ་༎
K10adbhutdu:18	 ca dṛṣṭvā ca punar me etad abhavat. yaḥ kaścic chrāddhaḥ kulaputro vā kuladuhitā	K10D0208_H0209:170a-13	མཐོང་ནས་ཀྱང་བདག་ཉིད་འདི་སྙམ་དུ་སེམས་ཏེ་།
K10adbhutdu:19	 vā īdṛśaṃ kūṭāgāraṃ caturdiśe bhikṣusaṃghe niryātayed yo vā tathāgatasyārhatḥ samyaksaṃbuddhasya	K10D0208_H0209:170b-0	གང་ཞིག་གིས་ཁང་པ་བརྩེགས་པ་འདི་ལྟ་བུ་ཞིག་བགྱིས་ཏེ་ཕྱོགས་བཞིའི་དགེ་སློང་གི་དགེ་༄༡༧༠བ་འདུན་ལ་དབུལ་བར་བགྱིད་པ་དང་། གང་ཞིག་གིས་དེ་བཞིན་གཤེགས་པ་ཡོངས་སུ་མྱ་ངན་འདས་པའི་རིང་བསྲེལ་ཡུངས་འབྲུ་ཙམ་མཆོད་རྟེན་གྱི་བུམ་པ་སྐྱུ་རུ་ར་ཙམ་གྱི་ནང་དུ་སྩལ་ཏེ་།
K10adbhutdu:2	 [1] athāyuṣmān ānandaḥ pūrvāhṇe nivāsya pātracīvaram ādāya rājagṛhaṃ piṇḍāya prāvikṣat.  adrākṣīd āyuṣmān ānando rājagṛhe nagare sāvadānaṃ piṇḍāya caramāṇo 'nyatamasmin pradeśe	K10D0208_H0209:169b-6	དེ་ནས་ཚེ་དང་ལྡན་པ་ཀུན་དགའ་བོ་སྔ་དྲོ་ཤམ་ཐབས་དང་། ཆོས་གོས་བགོས་ཏེ་། ལྷུང་བཟེད་ཐོགས་ནས་མཉན་ཡོད་དུ་བསོད་སྙོམས་ལ་སོང་ངོ་༎ མཉན་ཡོད་དུ་བསོད་སྙོམས་ལ་འགྲོ་བ་ན་།
K10adbhutdu:20	 parinirvṛtasya mṛttikāpiṇḍād āmalakapramāṇaṃ stūpaṃ pratiṣṭhāpayet sūcīmātrāṃ yaṣṭim  āropayed badarīpatramātraṃ cchatraṃ yavaphalapramāṇāṃ pratimāṃ kārayet sarṣaphalapramāṇaṃ	K10D0208_H0209:170b-1	སྲོག་ཤིང་ཁབ་ཙམ་བཙུགས་ནས་གདུགས་རྒྱ་ཤུག་གི་ལོ་མ་ཙམ་འདོགས་པར་བགྱིད་པའམ་། དེ་བཞིན་གཤེགས་པའི་སྐུ་གཟུགས་ཚོན་གང་པ་ཙམ་ཞིག་བགྱིད་ན་།
K10adbhutdu:22	 dhātuṃ pratiṣṭhāpayet tat katamaṃ tataḥ prabhūtataraṃ puṇyaṃ syāt?	K10D0208_H0209:170b-3	དེ་གཉིས་ལས་གང་བསོད་ནམས་ཆེས་མང་དུ་འཕེལ་སྙམ་བགྱིད་ལགས་ཏེ་།
K10adbhutdu:23	 tasya mamaitad abhavat. śāstā me saṃmukhībhūtaḥ sugato me saṃmukhībhūtaḥ. yanv aham etam evārthaṃ bhagavata ārocayeyaṃ yathā bhagavāṃ vyākariṣyati tathāhaṃ dhārayiṣyāmīty.	K10D0208_H0209:170b-4	བཅོམ་ལྡན་འདས་ལ་བདག་དོན་འདི་ཡོངས་སུ་ཞུ་ལགས་སོ་༎
K10adbhutdu:24	 [3] evam ukte bhagavān āyuṣmantam ānanda,	K10D0208_H0209:170b-5	དེ་སྐད་ཅེས་གསོལ་པ་དང་། བཅོམ་ལྡན་འདས་ཀྱིས་ཚེ་དང་ལྡན་པ་ཀུན་དགའ་བོ་ལ་འདི་སྐད་ཅེས་བཀའ་སྩལ་ཏོ་༎
K10adbhutdu:25	 idam avocat. sādhu sādhv ānanda bahujanahitāya tvam ānanda pratipanno ca bahujanasukhāya  lokānukampāyai arthāya hitāya sukhāya devamanuṣyāṇāṃ yas tvaṃ tathāgatam etam evārthaṃ  paripraṣṭavyaṃ manyase. tena hy ānanda śṛṇu sādhu ca suṣṭhu ca manasikuru,  bhāṣiṣye. jambūdvīpo hy ānanda dvīpaḥ saptayojanasahasrāṇy āyāmavistāreṇa uttaraviśālo  dakṣiṇena śakaṭāmukhaḥ tam enam kāscic chrāddhaḥ kulaputro vā kuladuhitā vā saptaratnamayaṃ  kṛtvā srotāpannebhyaḥ sakṛdāgāmibhyo 'nāgāmibhyo 'rhadbhyaḥ pratyekabuddhebhyaś cāturdiśe	K10D0208_H0209:170b-6	ཀུན་དགའ་བོ་། ལེགས་སོ་། ལེགས་སོ་༎
K10adbhutdu:39	 sūcīmātrāṃ yaṣṭim āropayed badarīpatramātraṃ cchattram yavaphalapramāṇaṃ pratimāṃ  kārayet sarṣaphalapramāṇaṃ dhātuṃ pratiṣṭhāpayet idam evānanda tataḥ bahutaraṃ puṇyaṃ vadāmi.  [5] tiṣṭhatv ānanda jambūdvīpo dvīpaḥ. asty ānandāvaragodānīyo nāma dvīpo navayojanasahasrāṇy  āyāmavistāreṇa samantāt pūrṇacandrākārapariṇāmitaḥ. tam enaṃ kaścic chrāddhaḥ kulaputro  vā kuladuhitā vā saptaratnamayaṃ kṛtvā yāvac cāturdiśe bhkiṣusaṃghe niryātayed yo	K10D0208_H0209:170b-9	ཁྱོད་གང་ཞིག་གིས་ཁང་བ་བརྩེགས་པ་དེ་ལྟ་བུ་ཞིག་བྱས་ཏེ་ཕྱོགས་བཞིའི་དགེ་སློང་གི་དགེ་འདུན་ལ་དབུལ་བར་བྱེད་ལ་།
K10adbhutdu:44	 vā tathāgatasyārhataḥ samyakasaṃbuddhasya parinirvṛttasya mṛtpiṇḍād āmalakaphalapramāṇaṃ	K10D0208_H0209:170b-10	གང་ཞིག་གིས་དེ་བཞིན་གཤེགས་པ་ཡོངས་སུ་མྱ་ངན་ལས་འདས་པའི་རིང་བསྲེལ་ཡུངས་འབྲུ་ཙམ་མཆོད་རྟེན་གྱི་བུམ་པ་སྐྱུ་རུ་ར་ཙམ་གྱི་ནང་དུ་བཅུག་སྟེ་།
K10adbhutdu:45	 stūpaṃ pratiṣṭhāpayet sūcīmātrāṃ yaṣṭim āropayed badarīpatramātraṃ cchattram yavaphalapramāṇaṃ	K10D0208_H0209:170b-11	སྲོག་ཤིང་ཁབ་ཙམ་བཙུགས་ནས་གདུགས་རྒྱ་ཤུག་གི་ལོ་མ་ཙམ་འདོགས་པར་བྱེད་པའམ་། དེ་བཞིན་གཤེགས་པའི་སྐུ་གཟུགས་ཚོན་གང་ཙམ་ཞིག་བྱེད་ན་།
K10adbhutdu:46	 pratimāṃ kārayet sarṣaphalapramāṇaṃ dhātuṃ pratiṣṭhāpayet idam evānanda tataḥ prabhūtataraṃ puṇyaṃ vadāmi.	K10D0208_H0209:170b-13	དེ་གཉིས་ལས་གང་བསོད་ནམས་ཆེས་མང་དུ་འཕེལ་ཞེས་པ་ནི་ཁྱོད་ཀྱི་ཞུ་བ་བཟུང་ལ་སྤོབས་པ་ལེགས་ཏེ་དཔྱོད་པ་དགེའོ་༎
K10adbhutdu:47	 [6] tiṣṭhatv ānanda jambūdvīpo dvīpaḥ. tiṣṭhatu pūrvavideho dvīpaḥ. tiṣṭhatv avaragodānīyo	K10D0208_H0209:170b-14	ཀུན་དགའ་བོ་།
K10adbhutdu:5	 dṛṣṭvā ca punas tasyaitad abhavat. yaḥ kaścic chrāddhaḥ kulaputro vā kuladuhitā vā	K10D0208_H0209:169b-10	སྒོ་གཏན་ལེགས་པར་བཅུག་པ་། སྐར་ཁུང་བཅད་པ་ཞིག་མཐོང་ངོ་༎ མཐོང་ནས་ཀྱང་འདི་སྙམ་དུ་སེམས་ཏེ་།
K10adbhutdu:56	 nāma prāsādaḥ. tam enaṃ kaścic chrāddhaḥ kulaputro vā kuladuhitā vā saptaratnamayaṃ	K10D0208_H0209:171a-3	གང་ཞིག་གིས་ཁང་པ་བརྩེགས་པ་དེ་ལྟ་བུ་ཞིག་བྱས་ནས་ཕྱོགས་བཞིའི་དགེ་སློང་གི་དགེ་འདུན་ལ་དབུལ་བར་བྱེད་ལ་།
K10adbhutdu:57	 kṛtvā yāvac cāturdiśe bhkiṣusaṃghe niryātayed yo vā tathāgatasyārhataḥ samyakasaṃbuddhasya  parinirvṛttasya mṛtpiṇḍād āmalakaphalapramāṇaṃ stūpaṃ pratiṣṭhāpayet sūcīmātrāṃ yaṣṭim  āropayed badarīpatramātraṃ cchattram yavaphalapramāṇaṃ pratimāṃ kārayet sarṣaphalapramāṇaṃ	K10D0208_H0209:171a-4	གང་ཞིག་གིས་དེ་བཞིན་གཤེགས་པ་ཡོངས་སུ་མྱ་ངན་ལས་འདས་པའི་རིང་བསྲེལ་ཡུངས་འབྲུ་ཙམ་མཆོད་རྟེན་གྱི་བུམ་པ་སྐྱུ་རུ་ར་ཙམ་གྱི་ནང་དུ་བཅུག་སྟེ་།
K10adbhutdu:6	 īdṛśaṃ kūṭāgāraṃ kārayitvā caturdiśe bhikṣusaṃghe niryātayed yo vā tathāgatasyārhatḥ  samyaksaṃbuddhasyāmalakapramāṇaṃ stūpaṃ pratiṣṭhāpayet sūcīmātrāṃ yaṣṭim āropayed	K10D0208_H0209:170a-0	གང་ཞིག་གིས་ཁང་པ་བརྩེགས་པ་འདི་ལྟ་བུ་ཞིག་བྱས་ཏེ་ཕྱོགས་བཞིའི་དགེ་སློང་གི་དགེ་འདུན་ལ་འབུལ་བར་བྱེད་པ་དང་། གང་ཞིག་གིས་དེ་བཞིན་གཤེགས་པ་ཡོངས་སུ་མྱ་ངན་ལས་འདས་པའི་རིང་བསྲེལ་ཡུངས་འབྲུ་ཙམ་མཆོད་རྟེན་གྱི་བུམ་༄༡༧༠ཨ་༌༎
K10adbhutdu:65	 'rhadbhyaḥ pratyekabuddhebhyaś yāvac cāturdiśe vā bhkiṣusaṃghe niryātayed yo vā tathāgatasyārhataḥ  samyakasaṃbuddhasya parinirvṛttasya mṛtpiṇḍād āmalakaphalapramāṇaṃ stūpaṃ pratiṣṭhāpayet  sūcīmātrāṃ yaṣṭim āropayed badarīpatramātraṃ cchattram yavaphalapramāṇaṃ pratimāṃ  kārayet sarṣaphalapramāṇaṃ dhātuṃ pratiṣṭhāpayet idam evānanda tataḥ prabhūtataraṃ puṇyaṃ vadāmi.	K10D0208_H0209:171a-6	དེ་བཞིན་གཤེགས་པའི་སྐུ་གཟུགས་ཚོན་གང་ཙམ་ཞིག་བྱེད་ན་།
K10adbhutdu:8	 badarīpatramātraṃ cchatraṃ yavaphalapramāṇāṃ pratimāṃ kārayet sarṣaphalapramāṇaṃ	K10D0208_H0209:170a-1	བ་སྐྱུ་རུ་ར་ཙམ་གྱི་ནང་དུ་བཅུག་སྟེ་། སྲོག་ཤིང་ཁབ་ཙམ་བཙུགས་ནས་གདུགས་རྒྱ་ཤུག་གི་ལོ་མ་ཙམ་འདོགས་པར་བྱེད་པའམ་།
K10adbhutdu:9	 dhātuṃ pratiṣṭhāpayet tat katamaṃ tataḥ prabhūtataraṃ puṇyaṃ syāt?  athāyuṣmata ānandasyaitad abhavat. śāstā me saṃmukhībhūtaḥ sugato me saṃmukhībhūtaḥ.  yaṇv aham etam evārthaṃ bhagavata ārocayeyaṃ yathā me sa bhagavāṃ vyākariṣyati tathāhaṃ dhārayiṣyāmīty.	K10D0208_H0209:170a-3	དེ་བཞིན་གཤེགས་པའི་སྐུ་གཟུགས་ཚོན་གང་ཙམ་ཞིག་བྱེད་ན་། དེ་གཉིས་ལས་གང་བསོད་ནམས་ཆེས་མང་དུ་འཕེལ་སྙམ་མོ་༎
