src_segmentnr	src_original	tgt_segmentnr	tgt_original
K10mkarmviu:1023	 ime daśa guṇā gandhapradānasya.  LXXVII. katame daśa guṇāḥ pravrajyāyāḥ. ucyate. putrabhāryaduhitṛdhanatṛṣṇāsya na  bhavati. kāmasya parigraho na bhavati. araṇyavāse prītiṃ pratilabhate. buddhagocaraṃ	K10Dx_H0344:489a-8	རབ་ཏུ་བྱུང་བའི་ཕན་ཡོན་བཅུ་ཡོད་དེ་། བཅུ་གང་ཞེ་ན་། དེ་བུ་དང་། ཆུང་མ་དང་། ནོར་ལ་སྲེད་པར་མི་འགྱུར་བ་དང་། དེ་འདོད་པའི་ཡོངས་སུ་འཛིན་པར་མི་འགྱུར་བ་དང་། དགོན་པར་གནས་པ་ལ་དགའ་བ་དང་། སངས་རྒྱས་ལ་གུས་པར་འགྱུར་བ་དང་། བདུད་ཀྱི་སྤྱོད་ཡུལ་རྣམ་པར་སྤོང་བ་དང་།
K10mkarmviu:1027	 sevate. bālagocaraṃ vivarjayati. durgatigamanīyān dharmān vivarjayati. sugatigamanīyān  dharmān sevate. devā asya spṛhayanti. nityaṃ sugatavacane pravrajyāṃ pratilabhate.	K10Dx_H0344:489b-0	བདེ་འགྲོ་ཐོབ་པར་བྱེད་པའི་ཆོས་རྣམས་ཡོངས་སུ་ཚོལ་བ་དང་། ངན་འགྲོ་འཐོབ་པར་བྱེད་པའི་ཆོས་རྣམས་སྤོང་བ་དང་། ལྷ་དང་མིར་སྨོན་པ་མེད་པ་དང་། རྟག་ཏུ་དེ་བཞིན་གཤེགས་པའི་གསུང་༄༤༨༩བ་རབ་ལ་རབ་ཏུ་འབྱུང་བར་འགྱུར་བ་དང་། མཐོ་རིས་སུ་སྐྱེ་བར་འགྱུར་བ་དང་། མྱུར་དུ་ཡོངས་སུ་མྱ་ངན་ལས་འདའ་བ་སྟེ་།
K10mkarmviu:1029	 ime daśa guṇāḥ pravrajyāyā bhavanti.  LXXVIII. katame daśa guṇā araṇyavāsasya. ucyate. saṃgaṇikā vivarjayati. pravivekaṃ	K10Dx_H0344:489b-2	ཆོས་བཅུ་པོ་དེ་དག་ནི་རབ་ཏུ་བྱུང་བའི་ཕན་ཡོན་ནོ་༎ དགོན་པ་ལ་གནས་པའི་ཕན་ཡོན་བཅུ་ཡོད་དེ་། བཅུ་གང་ཞེ་ན་།
K10mkarmviu:1031	 sevate. dhyānālambanaṃ cittaṃ bhavati. na ca bahukarmakṛtyatāṃ prāpnoti. buddhānāṃ  smṛtiṃ yāti. prītisukhasaumanasyaṃ kāyo na jahāti. antarāyāś ca na bhavanti. brahmacaryasya	K10Dx_H0344:489b-5	འདུ་འཛིན་རྣམ་པར་སྤོང་བ་དང་། རབ་ཏུ་དབེན་པ་ལ་བསྟེན་པ་དང་། དེའི་སེམས་བསམ་གཏན་ལ་དམིགས་པར་འགྱུར་བ་དང་། སངས་རྒྱས་བཅོམ་ལྡན་འདས་རྣམས་ལ་སྨོན་པ་དང་། དགའ་བ་དང་། བདེ་བ་དང་། ཡིད་བདེ་བ་ལུས་ལ་སྐྱེད་པ་དང་།
K10mkarmviu:1033	 alpāyāsena samādhim adhigacchati. uddiṣṭaṃ cāsya padavyañjanaṃ na naśyati. yathāśrutānāṃ  dharmāṇāṃ vistareṇārtham ājānati. ime daśa guṇā araṇyavāsasya.	K10Dx_H0344:489b-6	དེ་ལ་བར་དུ་གཅོད་པར་མི་འགྱུར་བ་དང་། ཇི་ལྟར་ཐོས་པའི་ཆོས་རྣམས་ཀྱི་དོན་རྒྱ་ཆེར་ཤེས་པར་འགྱུར་བ་དང་། ཞི་གནས་འཐོབ་པ་དང་། ལྷག་མཐོང་ཐོབ་པ་སྟེ་། བཅུ་པོ་དེ་དག་ནི་དགོན་པ་ལ་གནས་པའི་ཕན་ཡོན་ནོ་༎
K10mkarmviu:1035	 LXXIX. katame daśa guṇāḥ paiṇḍapātikatve. ucyate. caṅkramo 'sya upārjito bhavati. gocaro 'sya prahato bhavati. māno 'sya nihato (MKV 105)  bhavati. ātmānaṃ lābhena yojayati. parān puṇye pratiṣṭhāpayati. śāstuḥ śāsanaṃ dīpayati.	K10Dx_H0344:489b-8	བསོད་སྙོམས་ལེན་པའི་ཕན་ཡོན་བཅུ་ཡོད་དེ་། བཅུ་གང་ཞེ་ན་། དེ་འགྲོ་བ་ལ་གོམས་པར་འགྱུར་བ་དང་། དེ་སྤྱོད་ཡུལ་ལ་གོམས་པར་འགྱུར་བ་དང་། ང་རྒྱལ་བཅག་པར་འགྱུར་བ་དང་། བདག་རྙེད་པ་ལ་སྦྱོར་བ་དང་། གཞན་དག་ཀྱང་བསོད་ནམས་ལ་རབ་ཏུ་འགོད་པ་དང་། སྟོན་པའི་བསྟན་པ་ཡོངས་སུ་སྟོན་པ་དང་།
K10mkarmviu:1037	 paścimāyā janatāyā ālokaḥ kṛto bhavati. sabrahmacāriṇām upaghātaḥ kṛto na bhavati.	K10Dx_H0344:490a-0	ཕྱི་མའི་སྐྱེ་བོ་ལ་སྣང་བར་བྱས་པར་འགྱུར་བ་དང་། ཚངས་པ་མཚུངས་པར་སྤྱོད་པ་རྣམས་ལ་ཉམ་ང་བ་མེད་པར་བྱས་པར་འགྱུར་བ་དང་། དམའ་བའི་སེམས་ཉེ་བར་གཞག་པར་འགྱུར་བ་དང་། ༄༤༩༠ཨ་༌༎ བསོད་སྙོམས་ཀྱིས་ཡོངས་སུ་དུལ་བའི་དགེ་སྦྱོང་གི་ཕྱོགས་ལ་མུན་པ་མད་པར་སྣང་བའོ་༎ འཇིགས་པ་མེད་པའི་ཕན་ཡོན་བཅུ་ཡོད་དེ་། བཅུ་གང་ཞེ་ན་། འཇིགས་པ་མེད་པར་གྲོང་དུ་འཇུག་པ་དང་། འཇིགས་པ་མེད་པར་གྲོང་ནས་འབྱུང་བ་དང་། འཇིགས་པ་མེད་པར་ཁྱིམ་རྣམས་སུ་འགྲོ་བ་དང་། འཇིགས་པ་མེད་པར་འཁོར་རྣམས་ལ་ཆོས་སྟོན་པ་དང་། འཇིགས་པ་མེད་པར་དགེ་འདུན་གྱི་ནང་དུ་འཇུག་པ་དང་།
K10mkarmviu:1038	 nīcacittam upasthāpitaṃ bhavati. piṇḍapātaparacittasya bhikṣoḥ sarvā diśo 'pratikūlā	K10Dx_H0344:490a-5	འཇིགས་པ་མེད་པར་སློབ་དཔོན་དང་མཁན་པོའི་དྲུང་དུ་འགྲོ་བ་དང་། འཇིགས་པ་མེད་པར་བྱམས་པའི་སེམས་ཀྱིས་སློབ་མའི་གན་དུ་འགྲོ་བ་དང་། འཇིག་པ་མེད་པར་གོས་དང་། ཟས་དང་། མལ་ཆ་དང་། ན་བའི་གསོས་སྨན་དང་། ཡོ་བྱད་རྣམས་ཡོངས་སུ་སྤྱོད་པ་དང་། འཇིགས་པ་མེད་པར་ཁ་ཏོན་འདོན་པ་དང་། འཇིགས་པ་མེད་པར་ཚེ་འཕོ་བའི་དུས་བྱེད་པའོ་༎ བྲམ་ཟེའི་ཁྱེའུ་།
K10mkarmviu:1042	 viśāradaḥ saṃghamadhyam avatarati. viśārada ācāryopādhyāyān upasaṃkrāmati. viśārado  maitracittaḥ śiṣyān anuśāsti. viśāradaś cīvarapiiiḍapātaśayanāsanaglānapratyayabhaiṣajyapariṣkārān	K10Dx_H0344:490b-0	བྲམ་ཟེའི་ཁྱེའུ་ཤུ་ཀ་༄༤༩༠བ་བཅོམ་ལྡན་འདས་ལ་སེམས་མངོན་པར་དད་དོ་༎ དེ་ནས་བྲམ་ཟེའི་ཁྱེའུས་བཅོམ་ལྡན་འདས་ལ་འདི་སྐད་ཅེས་གསོལ་ཏོ་༎ གོཨོ་ཏ་མ་། ཁྱོད་མཉན་དུ་ཡོད་པར་དགེ་བསྙེན་གཞན་དག་གི་ཁྱིམ་དུ་གཤེགས་པར་དགོངས་ན་། བདག་གི་ཕ་བྲམ་ཟེ་ཏོའུ་དེ་ཡའི་ཁྱིམ་དུ་ཡང་གཤེགས་པར་དགོངས་སུ་གསོལ་།
K10mkarmviu:1045	 karmavibhaṅgasūtraṃ samāptam	K10Dx_H0344:490b-9	ལས་རྣམ་པར་འབྱེད་པ་རྫོགས་སོ་༎
K10mkarmviu:144	 uddeśaḥ karmavibhaṅgasya dharmaparyāyasya.  I. tatra katamat karma alpāyuḥsaṃvartanīyam?  ucyate. prāṇātipātaḥ. prāṇātipātasya anumodanam. prāṇātipātasya varṇavāditā. amitramaraṇābhinandanam.  amitramaraṇasya samādāpanam. amitramaraṇasya varṇavāditā. garbhaśātanam. garbhaśātanasya  varṇavāditā. sthaṇḍilapratiṣṭhāpanaṃ yatra bahavaḥ prāṇino ghātyante mahiṣapaśuśūkarakukkuṭādayaḥ	K10Dx_H0344:456a-0	དེ་ནི་སྲོག་གཅོད་པ་དང་། སྲོག་གཅོད་པ་ལ་རྗེས་སུ་དགའ་བ་དང་། སྲོག་གཅོད་པའི་ལེགས་པ་བརྗོད་པ་དང་། མི་མཛའ་བ་ཚེ་འཕོ་བར་བསྐུལ་བ་དང་། མི་མཛའ་བ་ཚེ་འཕོས་༄༤༥༦ཨ་༌༎ ན་ལེགས་པར་བརྗོད་པ་དང་། མངལ་ནས་ཚེ་འཕོ་བར་བྱེད་པ་དང་། མངལ་ནས་ཚེ་འཕོ་བའི་ལེགས་པ་བརྗོད་པ་དང་། མ་ཧེ་དང་། བ་ལང་དང་། ཕ་ལ་དང༏་བྱ་ལ་སོགས་པ་བསད་པར་འགྱུར་བའི་རྟེན་འཆའ་ཞིང་། མཆོད་སྦྱིན་དེ་བཙུགས་པས་བུ་ཚ་དང་། སྐྱེ་བོ་གཞན་ལ་ཕན་པར་འདོད་པ་རྣམས་དང་། འཇིགས་པས་ཉེན་པ་རྣམས་ཀྱི་ལུགས་སུ་གྱུར་ཅིང་སེམས་ཅན་གསོད་པར་འགྱུར་བ་སྟེ་། དཔེར་ན་། གྲོང་ཁྱེར་ཀས་མརྱ་ན་དགེ་སློང་དགྲ་བཅོམ་པ་གཅིག་ཅིག་ཁྱིམ་ཞིག་གི་སྒོ་ན་འདུག་འདུག་ན་། ཁྱིམ་དེའི་ཐད་ཀ་ལམ་པོ་ཆེ་ནས་ཕྱུགས་ཤིག་སྒྲ་འབྱིན་ཅིང་ཁྲིད་པ་དགེ་སློང་དེས་མཐོང་ནས་ཀྱི་ཧུད་ཨཨེ་མ་ག་ལ་སྲིད་ཅེས་བྱས་པ་དང་། མི་དག་གིས་དགེ་སློང་དེ་ལ་།
K10mkarmviu:149	 tasya yajñapravartakasya putrāḥ pautrāś cānye ca janāḥ phalārthino bhayabhītāś cānuvṛttiṃ  kurvāṇāḥ sattvān nirghātayanti.  a) yathā kāśmīrāyāṃ mahānagaryāṃ bhikṣuḥ kilārhann anyatarasmin gṛhadvāre tiṣṭhati.  tasya gṛhasya pārśvena rājapathas tena paśū ravamāṇo nīyate. sa bhikṣus taṃ dṛṣṭvā  hāhā dhik kaṣṭam iti vadati. puruṣās taṃ pṛcchanti. ārya kim ayaṃ hādhikkaṣṭam iti  śabdaḥ. sa āha. na vaktavyam etad aśrāddhānām. kāryārthaṃ tu bravīmi. ya eṣa paśū	K10Dx_H0344:456a-9	རྟེན་བཙུགས་ཏ་ལོ་དུས་ཀྱི་མཆོད་སྦྱིན་བྱས་ནས་།
K10mkarmviu:156	 ca paśuyajñaḥ pravartitaḥ. tatrānena bahavaḥ paśavo ghātitāḥ. maraṇakāle ca putrān	K10Dx_H0344:456a-10	དེས་དེར་ཕྱུགས་མང་པོ་དག་ཀྱང་བསད་། ཚེ་འཕོ་ཀར་ཡང་བུལ་བོས་ཏེ་སྨྲས་པ་།
K10mkarmviu:157	 āhūya prāha. putrāḥ. yady asti mayi sneho ya eṣa mayā sāṃvatsarikaḥ paśuyajñaḥ pravartitaḥ.	K10Dx_H0344:456a-12	བུ་ཁྱོད་ང་ལ་བྱམས་ཞ་ན་། ཕྱུགས་ཀྱི་མཆོད་སྦྱིན་ལོ་དུས་སུ་བྱ་བ་འདི་ང་ཚེ་འཕོས་ནས་༄༤༥༦བ་ཀྱང་རྟག་པར་གྱིས་ཤིག་ཅེས་བསྒོ་ནས་།
K10mkarmviu:158	 eṣa mayi kālagate 'nupravartayitavya iti. putrais tathāstv iti pratiśrutam. sa kālagatas	K10Dx_H0344:456b-1	བུས་ཀྱང་དེ་ལྟར་བགྱིའོ་ཞེས་ཏེ་དེ་བཞིན་དུ་མཉན་ཏོ་༎
K10mkarmviu:159	 tena mohajena prāṇātipātena (MKV 33)  samanvāgataḥ svagṛhe paśuḥ pratyājātaḥ. sa tatra jātau jātau ghātyate. adhunā ekaṣaṣṭitamaṃ	K10Dx_H0344:456b-2	དེ་ནས་མི་དེ་ཚེ་འཕོས་བ་དང་། གཏི་མུག་ལས་བྱུང་བའི་སྲོག་གཅོད་པ་དང་ལྡན་པས་བདག་གི་ཁྱིམ་དུ་ཕྱུགས་སུ་སྐྱེས་ནས་དེ་དེར་ཡང་དང་། ཡང་སྐྱེས་ཤིང་བསད་བསད་པ་ལས་ལན་འདི་དང་དྲུག་སྟེ་དེ་ཡང་ཁྲིད་པ་ཡིན་ནོ་ཞེས་ནས་།
K10mkarmviu:161	 vāraṃ nīyate. atha sa bhikṣus taṃ paśuṃ karuṇāyamāṇa āha. svayam eva te sthaṇḍilaṃ	K10Dx_H0344:456b-3	དགེ་སློང་དེས་ཕྱུགས་དེ་ལ་སྙིང་བརྩེ་བས་འདི་སྐད་ཅེས་སྨྲས་སོ་༎ རྟེན་ཀྱང་ཁྱོད་བདག་གིས་བཙུགས་། མཆོད་སྦྱིན་ཡང་ཁྱོད་བདག་གིས་བྱས་།
K10mkarmviu:162	 kṛtaṃ svayam eva yajñaḥ pravartitaḥ bahavaḥ paśavaś ca ghātitāḥ. kiṃ ravase. sarvam idaṃ nirarthakam.  b) yathaivaṃvidhaṃ sthaṇḍilapratiṣṭhāpanam. tathā yuddhadarśanam. yatra bahavaḥ sattvā ghātyante hastyaśvamanuṣyādayaḥ. yuddhapratibaddhānāṃ ca śastrāṇām abhinandanam.	K10Dx_H0344:456b-6	ཕྱུགས་མང་པོར་ཡང་ཁྱོད་བདག་གིས་བསད་ན་། ངེ་དེ་སྐད་དུ་དོན་མེད་པ་བོས་པས་ཅི་ལ་ཕན་ཞེས་བརྗོད་པ་ལྟ་བུ་སྟེ་།
K10mkarmviu:164	 c) yathā coktaṃ bhagavatā vaiśālyāṃ kālikasūtre. prāṇātipāta ānanda sevito bahulīkṛto	K10Dx_H0344:456b-9	ནག་པོ་ཡོད་པའི་མདོ་ལས་བཅོམ་ལྡན་འདས་ཀྱིས་གསུངས་པ་། ཀུན་དགའ་བོ་། སྲོག་གཅོད་པ་ལ་བསྟེན་ཅིང་གོམས་པར་བྱས་པ་དང་མང་དུ་བྱས་པ་ནི་སེམས་ཅན་དམྱལ་བར་སྐྱེ་བའི་རྒྱུར་འགྱུར་རོ་༎
K10mkarmviu:165	 niraya saṃvartanīyo bhavati. tiryagyonisaṃvartanīyo 'pi bhavati. pretaviṣayasaṃvartanīyo	K10Dx_H0344:456b-12	དུད་འགྲོའི་སྐྱེ་གནས་སུ་སྐྱེ་བའི་རྒྱུར་འགྱུར་རོ་༎ ཡི་དབ༹གས་སུ་སྐྱེ་བའི་རྒྱུར་འགྱུར་རོ་ཞེས་གསུངས་ཏེ་།
K10mkarmviu:166	 'pi bhavati. yasmād alpaprāṇātipātasya vipāko manuṣyabhūtasya sato alpāyuḥsaṃvartanīyo 'pi bhavati.  d) tathā daśādīnavā nandikasūtra uktāḥ prāṇātipātasya.	K10Dx_H0344:456b-14	སྲོག་གཅོད་བ་ནི་ཉུང་ཞིང་ཆུང་ཡང་རྣམ་པར་སྨིན་པ་ཚེ་ཐུང་བར་འགྱུར་རོ་༎
K10mkarmviu:168	 idaṃ karma alpāyuḥsaṃvartanīyam.  II. tatra katamat karma dīrghāyuḥsaṃvartanīyam. ucyate. prāṇātipātān nivṛttiḥ. prāṇātipātanivṛttau	K10Dx_H0344:456b-15	དེ་ལ་ཚེ་རིང་བར་འགྱུར་བའི་ལས་ཡོད་དེ་།
K10mkarmviu:211	 III. katamat karma bahvābādhāsaṃvartanīyam. ucyate. khaṭacapeṭapradānam. khaṭacapeṭapradānasyānumodanam.	K10Dx_H0344:457a-6	ཞིག་ཅིང་རལ་བ་སུས་བཅོས་པ་༎ དེ་ལ་ཚེ་འཕྲོག་བདུད་མི་འབྱུང་༎ ཞེས་གསུངས་པ་ལྟ་བུ་སྟེ་། ལས་དེ་ལྟ་བུ་ནི་ཚེ་རིང་བར་འགྱུར་བའོ་༎ དེ་ལ་ནད་མང་བར་འགྱུར་བའི་ལས་ཡོད་དེ་།
K10mkarmviu:212	 khaṭacapeṭapradānasya varṇavāditā. teṣāṃ pradānena tuṣṭiḥ. mātāpitroś cittaśarīre  pīḍākaraṇaṃ tathānyeṣāṃ pravrajitānāṃ śīlavatāṃ cittasaṃkleśaḥ. amitravyādhinā tuṣṭiḥ.	K10Dx_H0344:457a-11	དེ་གང་ཞེ་ན་། དེ་ནི་ཁྲོ་བ་དང་། ཁུ་ཚུར་དང་། ཐལ་མོས་རྡེག་པ་དང་། ཁུ་ཚུར་དང་། ཐལ་མོས་རྡེག་པ་ལ་རྗེས་སུ་དགའ་བ་དང་། ཁུ་ཚུར་དང་། ཐལ་མོས་རྡེག་པའི་ཡོན་ཏན་བརྗོད་པ་དང་། དེ་ལ་བསྐུལ་བ་དང་། ཕ་མའི་སེམས་དང་ལུས་མི་བདེ་བར་བྱས་པ་དང་། རབ་ཏུ་འབྱུང་བ་ཚུལ་ཁྲིམས་དང་ལྡན་པ་དག་གི་༄༤༥༧བ་སེམས་མི་བདེ་བར་བྱས་པ་དང་། མི་མཛའ་བ་ནད་ཀྱིས་བཏབ་པ་ལ་དགའ་བར་སེམས་པ་དང་། མི་མཛའ་བ་ནད་སོས་ན་མི་དགའ་བར་སེམས་པ་དང་།
K10mkarmviu:214	 amitravyādhivyutthānenātuṣṭiḥ. vyādditānām abhaiṣajyapradānam. tathāparijīrṇabhojanam.	K10Dx_H0344:457b-1	ནད་པ་ལ་སྨན་མ་ཡིན་པ་བྱིན་པ་དང་། ཟས་མ་ཞུ་བར་བསྟབས་པ་སྟེ་།
K10mkarmviu:215	 idaṃ karma bahvābādhāsaṃvartanīyam.	K10Dx_H0344:457b-2	ལས་དེ་ལྟ་བུ་ནི་ནད་མང་བར་འགྱུར་རོ་༎
K10mkarmviu:216	 IV. katamat karma alpābādhāsaṃvartanīyam. ucyate. khaṭacapeṭapradānān nivṛttiḥ. tatra  samādāpanam. tadvarṇavāditā. tadabhyanumodanam. glānānāṃ mātāpitṝṇām upasthānakaraṇam.	K10Dx_H0344:457b-3	དེ་ལ་ནད་ཉུང་བར་འགྱུར་བའི་ལས་ཡོད་དེ་། དེ་གང་ཞེ་ན་། དེ་ནི་ཐལ་མོ་དང་། ཁུ་ཚུར་གྱིས་རྡེག་པ་དང་། ཐལ་མོ་དང་། ཁུ་ཚུར་གྱིས་རྡེག་པ་སྤོང་བར་བསྐུལ་བ་དང་། དེའི་ཡོན་ཏན་བརྗོད་པ་དང་། དེ་ལ་རྗེས་སུ་དགའ་བ་དང་། ཕ་མ་ན་བའི་རིམ་གྲོ་བྱེད་པ་དང་།
K10mkarmviu:218	 tad apy anyeṣāṃ gṛhasthapravrajitānām. amitravyādhinānāttamanaskatā. tasya vyutthānena	K10Dx_H0344:457b-6	ཁྱིམ་པ་དང་། རབ་ཏུ་བྱུང་བ་དང་། རྒན་ནམ་། གཞོན་ཡང་རུང་སྟེ་།
K10mkarmviu:219	 cāttamanaskatā. bhaiṣajyapradānam. parijīrṇabhojanaṃ ca. idaṃ karma alpābādhāsaṃvartanīyam.	K10Dx_H0344:457b-8	ན་ན་རིམ་གྲོ་བྱེད་པ་དང་། མི་མཛའ་བ་ནའང་མི་དགའ་བར་སེམས་པ་དང་། དེའི་ནད་སོས་ན་དགའ་བར་སེམས་པ་དང་། སྨན་གྱི་སྦྱིན་པ་བྱེད་པ་དང་། ཁ་ཟས་ཞུ་ནས་སྟོབས་པ་སྟེ་། ལས་དེ་ལྟ་བུ་ནི་ནད་ཉུང་བར་འགྱུར་རོ་༎
K10mkarmviu:220	 V. katamat karma durvarṇasaṃvartanīyam. ucyate. krodhaḥ. upanāhaḥ mrakṣaḥ. pradāśaḥ. mātāpitror avarṇavāditā. anyeṣāṃ ca (MKV 38)	K10Dx_H0344:457b-10	དེ་ལ་ཁ་དོག་མི་སྡུག་པར་འགྱུར་པའི་ལས་ཡོད་དེ་། དེ་གང་ཞེ་ན་། དེ་ནི་ཁྲོ་བ་དང་། འཁོན་དུ་འཛིན་པ་དང་། འཆབ་པ་དང་། ཚིག་པ་དང་། ཕ་མ་ལ་ངན་དུ་བརྗོད་པ་དང་། ཁྱིམ་པ་དང་། རབ་ཏུ་བྱུང་བ་རྒན་གཞོན་ལ་ངན་དུ་བརྗོང་པ་དང་། མཆོད་རྟེན་དང་།
K10mkarmviu:222	 stūpānāṃ pratimāṇāṃ ca dīpavyucchedaḥ. durvarṇānāṃ sattvānām avahasanam. tathā caukṣasamudācāratā.	K10Dx_H0344:458a-0	གཙུག་ལག་ཁང་དང་། མཆོད་རྟེན་གྱི་ས་གཞི་མི་སྡུག་པར་བྱས་པ་དང་། མཆོད་རྟེན་དང་། སྐུ་གཟུགས་ཀྱི་མར་མེ་བསད་པ་དང་། སེམས་ཅན་ཁ་དོག་མི་སྡུག་པ་རྣམས་ལ་༄༤༥༨ཨ་༌༎
K10mkarmviu:223	 idaṃ karma durvarṇasaṃvartanīyam.	K10Dx_H0344:458a-1	ཕྱས་འདོགས་པ་དང་། གཙང་སྦྲ་ཆུང་བ་སྟེ་། ལས་དེ་ལྟ་བུ་ནི་ཁ་དོག་མི་སྡུག་པར་འགྱུར་བའོ་༎
K10mkarmviu:224	 VI. katamat karma prāsādikasaṃvartanīyam. ucyate. akrodhaḥ. anupanāhaḥ. amrakṣaḥ.	K10Dx_H0344:458a-3	དེ་ལ་མཛེས་པར་འགྱུར་བའི་ལས་ཡོད་དེ་། དེ་གང་ཞེ་ན་།
K10mkarmviu:225	 vastrapradānam. stūpacaityagṛheṣu ca sudhādānam. suvarṇapātra dānam. gandhalepapradānam.  alaṃkārapradānam. mātāpitror varṇavāditā. āryāṇāṃ śīlavatāṃ varṇavāditā stūpāṅgaṇavihārāṇāṃ  saṃmārjanam. satataṃ gṛhasaṃmārjanam. virūpāṇāṃ sattvānām anavahasanaṃ tathānyeṣāṃ  bālavṛddhānām. tathā caukṣasamudācāratā.	K10Dx_H0344:458a-5	དེ་ནི་མི་ཁྲོ་བ་དང་། འཁོན་དུ་མི་འཛིན་པ་དང་། མི་འཆབ་པ་དང་། མི་ཚིག་པ་དང་། གོས་ཀྱི་སྦྱིན་པ་བྱེད་པ་དང་། མཆོད་རྟེན་དང་། གཙུག་ལག་ཁང་དག་ལ་རྡོ་ཐལ་གྱིས་སྐྱང་ནུལ་བྱེད་པ་དང་།
K10mkarmviu:235	 tathaivāyaṃ śobhitavān. idaṃ karma prāsādikasaṃvartaniyam.	K10Dx_H0344:458a-9	ལས་དེ་ལྟ་བུ་ནི་མཛེས་པར་འགྱུར་བའོ༏་༏དེ་ལ་མཐུ་ཆུང་བར་འགྱུར་བའི་ལས་ཡོད་དེ་།
K10mkarmviu:236	 (MKV 39)  VII. katamat karma alpeśākhyasaṃvartanīyam. ucyate. īrṣyā. mātsaryam. parasya lābhenātuṣṭiḥ.	K10Dx_H0344:458a-10	དེ་གང་ཞེ་ན་། དེ་ནི་སེར་སྣ་བྱེད་པ་དང་། ཕྲག་དོག་ཆེ་བ་དང་། གཞན་གྱིས་ཐོབ་ན་མི་དགའ་བ་དང་། གཞན་ལ་མི་སྙན་པར་བརྗོད་ན་དགའ་བ་དང་། ཕ་མ་ལ་བརྙས་པ་དང་། འཕགས་པ་དང་། ཚུལ་ཁྲིམས་དང་ལྡན་པ་ལ་བརྙས་པ་དང་།
K10mkarmviu:238	 parasya varṇavāditāyā atuṣṭiḥ. mātāpitroḥ paribhavaḥ. āryāṇāṃ śīlavatāṃ paribhavaḥ.  tathānyeṣāṃ vyādhitabālavṛddhānām. hīne dharmahīne 'kuśalamūle varṇavāditā. bodhicittotpādasya	K10Dx_H0344:458b-0	ནད་པ་དང་། རྒན་པ་དང་། གཞོན་པ་ལ་བརྙས་པ་དང་། ཆོས་༄༤༥༨བ་ངན་པ་དང་། མི་དགེ་བའི་རྩ་བའི་ལེགས་པ་བརྗོད་པ་དང་། བྱང་ཆུབ་ཀྱི་སེམས་ལས་བཟློག་པ་སྟེ་།
K10mkarmviu:240	 nivāraṇam. tadabhyanumodanam. idaṃ karma alpeśākhyasaṃvartanīyam.	K10Dx_H0344:458b-1	ལས་དེ་ལྟ་བུ་ནི་མཐུ་ཆུང་བར་འགྱུར་བའོ་༎
K10mkarmviu:241	 VIII. katamat karma maheśākhyasaṃvartanīyam. ucyate. anīrṣyā. amātsaryam. paralābhena  tuṣṭiḥ. parasya yaśovarṇaśabdaślokaśravaṇena tuṣṭiḥ. parasya varṇavāditāyā āttamanaskatā.	K10Dx_H0344:458b-2	དེ་ལ་མཐུ་ཆེ་བར་འགྱུར་བའི་ལས་ཡོད་དེ༏་དེ་གང་ཞེ་ན་། དེ་ནི་ཕྲག་དོག་མེད་པ་དང་། སེར་སྣ་མེད་པ་དང་། གཞན་གྱིས་ཐོབ་ན་དགའ་བ་དང་། གཞན་གྱིས་མ་ཐོབ་ན་མི་དགའ་བ་དང་། གཞན་གྱི་གྲགས་པ་དང་། སྒྲ་དང༏་ཚིག་སུ་བཅད་པ་སྙན་པ་ཐོས་ན་དགའ་བ་དང་།
K10mkarmviu:243	 bhagavataś caityastūpakārāpaṇam. hīne dharmahīne 'kuśalamūle nivāraṇam. maheśākhyakuśalamūle	K10Dx_H0344:458b-4	གཞན་གྱི་ལེགས་པ་བརྗོད་པ་ལ་དགའ་བ་དང་། བཅོམ་ལྡན་འདས་ཀྱི་མཆོད་རྟེན་དང་། གཙུག་ལག་ཁང་བརྩིག་པ་དང༏་ཆོས་ངན་པ་དང་། མི་དགེ་བའི་རྩ་བ་ལས་བཟློག་པ་དང་། མཐུ་ཆེ་བར་འགྱུར་བའི་དགེ་བའི་རྩ་བ་ལ་བསྐུལ་བ་དང་།
K10mkarmviu:244	 samādāpanam. bodhicittotpādanam. sarvamaheśākhyakuśalamūle bodhicittotpādanam.  a) yathoktaṃ bhagavatā vārāṇasyāṃ pūrvāparāntake sūtre (MKV 40)  maitreyas tuṣitasurālayādhivāsī  sa śrīmān daśabalatām avāpya śīghraṃ  lokānāṃ bhavatu śaśīva nityapūjyaḥ.	K10Dx_H0344:458b-5	བྱང་ཆུབ་ཏུ་སེམས་བསྐྱེད་པ་དང་། དགེ་བའི་རྩ་བ་ཐམས་ཅད་ཀྱིས་མཐུ་ཆེན་པོར་སེམས་བསྐྱེད་པ་སྟེ་།
K10mkarmviu:251	 idaṃ karma maheśākhyasaṃvartanīyam.	K10Dx_H0344:458b-6	ལས་དེ་ལྟ་བུ་ནི་མཐུ་ཆེ་བར་འགྱུར་བའོ་༎
K10mkarmviu:252	 IX. katamat karma nīcakulasaṃvartanīyam. ucyate. stabdhatā. abhimānitā ca. amātāpitṛjñatā.  aśrāmaṇyatā. abrāhmaṇyatā. akulajyeṣṭhāpacāyitā. mātāpitror apratyupasthānam. āryāṇāṃ	K10Dx_H0344:458b-7	དེ་ལ་རིགས་དམའ་བར་འགྱུར་བའི་ལས་ཡོད་དེ་། དེ་གང་ཞེ་ན་། དེ་ནི་ཕོ་ཐེག་ཆེ་བ་དང་། ང་རྒྱལ་བྱེད་པ་དང་། ཕར་མི་འཛིན་པ་དང་། མར་མི་འཛིན་པ་དང་། དགེ་སྦྱོང་དུ་མི་འཛིན་པ་དང་། བྲམ་ཟེར་མི་འཛིན་པ་དང་། རིགས་ཀྱི་གཙོ་བོ་ལ་རིམ་གྲོ་མི་བྱེད་པ་དང་།
K10mkarmviu:254	 śīlavatām apratyupasthānam. anyeṣāṃ ca gurusthānīyānām ācāryopādhyāyānām apratyupasthānam.	K10Dx_H0344:459a-0	ཕ་མ་ལ་རིམ་གྲོ་མི་བྱེད་པ་དང་། འཕགས་པ་དང་། ཚུལ་ཁྲིམས་དང་ལྡན་པ་རྣམས་ལ་རིམ་གྲོ་མི་བྱེད་པ་དང་། བླ་མར་གྱུར་པ་གཞན་དང་། མཁན་པོ་དང་། ༄༤༥༩ཨ་༌༎
K10mkarmviu:255	 nīcakulānāṃ satvānāṃ paribhavaḥ. idaṃ karma nīcakulasaṃvartanīyam.	K10Dx_H0344:459a-1	སློབ་དཔོན་ལ་རིམ་གྲོ་མི་བྱེད་པ་དང་། སེམས་ཅན་རིགས་དམའ་བ་རྣམས་ལ་བརྙས་པ་སྟེ་། ལས་དེ་ལྟ་བུ་ནི་རིགས་དམའ་བར་འགྱུར་བའོ་༎
K10mkarmviu:256	 X. katamat karma uccakulasaṃvartanīyam. ucyate. astabdhatā. anabhimānitā. mātāpitṛjñatā.  śrāmaṇyatā. brāhmaṇyatā. kulajyeṣṭhāpacāyitā. mātāpitroḥ pratyupasthānam. āryāṇāṃ	K10Dx_H0344:459a-3	དེ་ལ་རིགས་མཐོ་བར་འགྱུར་བའི་ལས་ཡོད་དེ་། དེ་གང་ཞེ་ན་། དེ་ནི་ཕོ་ཐེག་ཆུང་བ་དང་། ང་རྒྱལ་མེད་པ་དང་། ཕར་འཛིན་པ་དང་། མར་འཛིན་པ་དང་། དགེ་སྦྱོང་དུ་འཛིན་པ་དང་། བྲམ་ཟེར་འཛིན་པ་དང་། རིགས་ཀྱི་གཙོ་བོ་རྣམས་ལ་རིམ་གྲོ་བྱེད་པ་དང་།
K10mkarmviu:258	 śīlavatāṃ pratyupasthānam. anyeṣāṃ ca gurusthānīyānām ācāryopādhyāyānāṃ pratyupasthānam.	K10Dx_H0344:459a-6	ཕ་མ་ལ་རིམ་གྲོ་བྱེད་པ་དང་། འཕགས་པ་དང་ཚུལ་ཁྲིམས་དང་ལྡན་པ་རྣམས་ལ་རིམ་གྲོ་བྱེད་པ་དང༏་མཁན་པོ་དང་སློབ་དཔོན་ལ་རིམ་གྲོ་བྱེད་པ་དང་། བླ་མར་གྱུར་པ་གཞན་དག་ལ་རིམ་གྲོ་བྱེད་པ་དང་།
K10mkarmviu:259	 nīcakulānāṃ satvānām aparibhavaḥ.	K10Dx_H0344:459a-7	སེམས་ཅན་རིགས་དམའ་བ་རྣམས་ལ་མི་བརྙས་པ་སྟེ་།
K10mkarmviu:260	 a) yathā ca bhagavatā sūtra uktam. yato bhikṣavaḥ kuśalaśīlavanto brahmacārinaḥ kalyāṇadharmāṇaḥ	K10Dx_H0344:459a-8	དཔེར་ན༏་བཅོམ་ལྡན་འདས་ཀྱིས་མདོ་ལས་གསུངས་པ་། དགེ་སློང་དག་།
K10mkarmviu:261	 pravrajitā upasaṃkramanti pañca tasmin kule 'nuśaṃsāḥ pratyanuśaṃsitavyāḥ. katame	K10Dx_H0344:459a-10	གྲོང་གང་དུ་རབ་ཏུ་བྱུང་བ་ཚུལ་ཁྲིམས་དང་ལྡན་ཞིང་ཚངས་པར་སྤྱོད་པ་། དགེ་བའི་ཆོས་ཅན་རྣམས་འོང་བའི་གྲོང་དེར་ལེགས་པ་ལྔ་འབྱུང་བར་རིག་པར་བྱ་སྟེ་།
K10mkarmviu:262	 pañca. iha bhikṣavaḥ upasaṃkrānteṣu śīlavatsu cittāni prasādayanti svargasaṃvartanīyaṃ (MKV 41)	K10Dx_H0344:459a-12	ལྔ་གང་ཞེ་ན་། དེ་ནི་ཚུལ་ཁྲིམས་དང་ལྡན་པ་འོངས་པ་རྣམས་ལ་སེམས་དད་པར་འགྱུར་རོ་༎ དགེ་སློང་དག་།
K10mkarmviu:263	 tad bhikṣavaḥ kulaṃ tasmin samaye pratipadaṃ pratipannaṃ bhavati. punar aparaṃ bhikṣavaḥ	K10Dx_H0344:459a-15	གཞན་ཡང་དེའི་ཚེ་།
K10mkarmviu:264	 upasaṃkrānteṣu śīlavatsu abhivādayanti pratyuttiṣṭhanti. uccakulasaṃvartanīyaṃ bhikṣavaḥ.	K10Dx_H0344:459a-16	རིགས་དེ་མཐོ་རིས་སུ་སྐྱེ་བའི་ལམ་དུ་ཞུགས་པ་ཡིན་ནོ་༎ དགེ་སློང་དག་། གཞན་ཡང་། ཚུལ་ཁྲིམས་དང་ལྡན་པ་དག་འོངས་ན་གུས་པར་སྨྲ་བ་དང་། བསུ་༄༤༥༩བ་པའི་ལས་བྱེད་དེ་།
K10mkarmviu:265	 tasmin samaye pratipadaṃ pratipannaṃ bhavati. evaṃ sarvasūtraṃ yojyam. idaṃ karma	K10Dx_H0344:459b-1	དེའི་ཚེ་རིགས་དེ་དག་རིགས་མཐོ་བར་འགྱུར་བའི་ལམ་དུ་ཞུགས་པ་ཡིན་ནོ་ཞེས་གསུངས་པ་ལྟ་བུ་སྟེ་།
K10mkarmviu:266	 uccakulasaṃvartanīyam.	K10Dx_H0344:459b-2	ལས་དེ་ལྟ་བུ་ནི་རིགས་མཐོ་བར་འགྱུར་བའོ་༎
K10mkarmviu:267	 XI. katamat karma alpabhogasaṃvartanīyam. ucyate. adattādānam. adattādānasamādāpanam.	K10Dx_H0344:459b-3	དེ་ལ་ལོངས་སྦྱོད་ཆུང་བར་འགྱུར་བའི་ལས་ཡོད་དེ་། དེ་གང་ཞེ་ན་།
K10mkarmviu:268	 cauryavarṇavāditā. tadabhyanumodanam. mātāpitror vṛttyupacchedaḥ. tathānyeṣāṃ vyādhitabālavṛddhakṛpaṇānāṃ	K10Dx_H0344:459b-5	དེ་ནི་མ་བྱིན་པར་ལེན་པ་དང་། མ་བྱིན་པར་ལེན་པར་བསྐུལ་བ་དང་། མ་བྱིན་པར་ལེན་པའི་ལེགས་པ་བརྗོད་པ་དང་། དེ་ལ་རྗེས་སུ་དགའ་བ་དང་། མ་བྱིན་པར་བླངས་པས་དགའ་བ་དང་། ཕ་མའི་འཚོ་བ་འཕྲོག་པ་དང་། འཕགས་པ་དང་ཚུལ་ཁྲིམས་དང་ལྡན་པའི་འཚོ་བ་འཕྲོག་པ་དང་། རབ་ཏུ་བྱུང་བ་རྣམས་དང་། བྱིས་པ་དང་། རྒན་པ་དང་། ཕོངས་པ་དང་། ནད་པ་རྣམས་ཀྱི་འཚོ་བ་འཕྲོག་པ་དང་། གཞན་གྱིས་མཐོབ་ན་དགའ་བ་དང་།
K10mkarmviu:269	 vṛttyupacchedaḥ. parasya lābhenātuṣṭiḥ. paralābhāntarāyakriyā durbhikṣābhinandanaṃ	K10Dx_H0344:459b-7	གཞན་གྱིས་ཐོབ་པར་འགྱུར་བ་ལ་བགེགས་བྱེད་པ་དང་། ལོ་ཉེས་སུ་དགའ་བ་སྟེ་།
K10mkarmviu:270	 ca. idaṃ karma alpabhogasaṃvartanīyam.	K10Dx_H0344:459b-8	ལས་དེ་ལྟ་བུ་ནི་ལོངས་སྤྱོད་ཆུང་བར་འགྱུར་བའོ་༎
K10mkarmviu:271	 XII. tatra katamat karma mahābhogasaṃvartanīyam. ucyate. adattādānān nivṛttiḥ pareṣāṃ	K10Dx_H0344:459b-9	དེ་ལ་ལོངས་སྤྱོད་ཆེ་བར་འགྱུར་བའི་ལས་ཡོད་དེ་། དེ་གང་ཞེ་ན་།
K10mkarmviu:272	 cādattādānān nivāraṇam. pareṣām adattādānanivṛttānāṃ samanumodanam. mātāpitror vṛttipradānam.	K10Dx_H0344:459b-11	དེ་ནི་མ་བྱིན་པར་ལེན་པ་སྤངས་པ་དང་། གཞན་གྱིས་མ་བྱིན་པར་ལེན་པ་སྤངས་ན་རྗེས་སུ་དགའ་བ་དང་། ཕ་མ་ལ་འཚོ་བ་འབུལ་བ་དང་། འཕགས་པ་དང་། ཚུལ་ཁྲིམས་དང་ལྡན་པ་རྣམས་ལ་འཚོ་བ་འབུལ་བ་དང་།
K10mkarmviu:273	 āryāṇāṃ ca śīlavatāṃ vṛttipradānam. tathānyeṣāṃ vyādhitabālavṛddhakṛpaṇānāṃ vṛttipradānam.  paralābhena tuṣṭiḥ. parasyālābhenātuṣdḥ. paralābhasamanumodanam. subhikṣābhinandanam.	K10Dx_H0344:460a-0	ནད་པ་དང་། བྱིས་པ་དང་། རྒན་པ་དང་། ཕོངས་པ་གཞན་ལའང་འཚོ་བའི་སྦྱིན་པ་བྱེད་པ་དང་། གཞན་གྱིས་ཐོབ་ན་དགའ་བ་དང་། ལོ་ལེགས་༄༤༦༠ཨ་༌༎ པར་དགའ་བ་སྟེ་།
K10mkarmviu:275	 a) tad eva sūtraṃ yojyam. punar aparaṃ bhikṣavaḥ upasaṃkrānteṣu śīlavatsu dānāni	K10Dx_H0344:460a-2	མདོ་དེ་ཉིད་ལས་། དགེ་སློང་དག་། གཞན་ཡང་། ཚུལ་ཁྲིམས་དང་ལྡན་པ་རྣམས་འོངས་པ་དག་ལ་སྦྱིན་པ་བྱེད་ཅིང་།
K10mkarmviu:276	 dadanti puṇyāni ca kurvanti. mahābhogasaṃvartanīyaṃ bhikṣavas tat kulaṃ tasmin samaye  pratipadaṃ pratipannaṃ bhavati. idaṃ karma mahābhogasaṃvartanīyam.	K10Dx_H0344:460a-5	བསོད་ནམས་བྱེད་པའི་རིགས་དེ་དག་དེའི་ཚེ་ལོངས་སྤྱོད་ཆེ་བར་འགྱུར་བའི་ལམ་དུ་ཞུགས་པ་ཡིན་ནོ་༎ ལས་དེ་ལྟ་བུ་ནི་ལོངས་སྤྱོད་ཆེ་བར་འགྱུར་བའོ་༎
K10mkarmviu:278	 XIII. tatra katamat karma duṣprajñasaṃvartanīyam. ucyate. ihaikatyo na parān pṛcchati.  paṇḍitān. śramaṇān. brāhmaṇān. ko dharmaḥ kiṃ dharmaṃ kurvataḥ śreyaskaram iti. api	K10Dx_H0344:460a-8	དེ་ལ་ཤེས་རབ་ཆུང་བར་འགྱུར་བའི་ལས་ཡོད་དེ་། དེ་གང་ཞེ་ན་། དེ་ནི་འདི་ལ་ལ་ལ་ཞིག་དགེ་སྦྱོང་ངམ་བྲམ་ཟེ་གཞན་དག་ལ་ཆོས་ནི་གང་ཡིན་། ཆོས་མ་ཡིན་པ་ནི་གང་ཡིན་།
K10mkarmviu:293	 bhagavan kasyaiṣa karmaṇo vipākena duṣprajñaḥ. bhagavān āha. kāśyape samyaksaṃbuddhe  parinirvṛte eṣa āraṇyako bhikṣus tripiṭakas tatkālam abhūt. bhikṣūṇāṃ ca buddhapūjām  akurvatāṃ buddhavacanam antarhitam. te bhikṣavas tasya samīpaṃ gatāḥ asmākaṃ buddhavacanam  antarhitam. asmākam apy upadeśaṃ kuruṣvety anena mātsaryadoṣāt teṣām upadeśo na kṛtaḥ.  evaṃ tacchāsanam antarhitam. tasya karmaṇo vipākenaiṣa duṣprajñaḥ. idaṃ karma duṣprajñasaṃvartanīyam.	K10Dx_H0344:460a-16	ལས་དེ་ལྟ་བུ་ནི་ཤེས་རབ་ཆུང་བར་འགྱུར་བའོ་༎
K10mkarmviu:298	 XIV. tatra katamat karma mahāprajñasaṃvartanīyam. ucyate. (MKV 44)	K10Dx_H0344:460a-17	དེ་ལ་ཤེས་རབ་ཆེ་བར་འགྱུར་བའི་ལས་ཡོད་དེ་། དེ་གང་ཞེ་ན་།
K10mkarmviu:299	 ihaikatyaḥ paripṛcchaka jātīyo bhavati paṇḍitāñ chramaṇān brāhmaṇān sevate duṣprajñān	K10Dx_H0344:460b-0	དེ་ནི་༄༤༦༠བ་འདི་ལ་ཡོངས་སུ་འདྲི་ཕོད་པའི་ངང་ཚུལ་ཅན་ལ་ལ་ཞིག་གིས་དགེ་སྦྱོང་དང་། བྲམ་ཟེ་མཁས་པ་ལ་འདྲི་བ་དང་། ཤེས་རབ་འཆལ་བ་ཡོངས་སུ་སྤོང་བ་དང་། དམ་པའི་ཆོས་སྟོན་ཅིང་གསལ་བར་བྱེད་པ་དང་།
K10mkarmviu:300	 parivarjayati. saddharmaṃ dīpayati. asaddharmaṃ vigarhati dharmabhāṇakānāṃ vaiśāradyaṃ	K10Dx_H0344:460b-1	དམ་པའི་ཆོས་མ་ཡིན་པ་ལ་རྣམ་པར་སྨོད་པ་དང་། ཆོས་སྨྲ་བ་རྣམས་ལ་མི་འཇིགས་པ་ཉེ་བར་སྒྲུབ་པ་དང་། རིགས་པ་ལ་ལེགས་སོ་ཞེས་ཟེར་བ་དང་། མི་རིགས་པ་ཡོངས་སུ་སྤོང་བ་དང་། ཡང་དག་པར་ལྟ་བའི་ལེགས་པ་བརྗོད་པ་དང་།
K10mkarmviu:301	 varṇayati. sahitabhāṣiṇāṃ sādhukāraṃ dadāti. ahitabhāṣiṇaṃ pariharati. samyagdṛṣṭiṃ  varṇayati. mithyādṛṣṭiṃ vigarhati. masīpustakalekhanīpradānāni dadāti. na ca madyaṃ	K10Dx_H0344:460b-2	ལོག་པར་ལྟ་བ་ལ་ཉེས་པར་དམོད་པ་དང་། གླེགས་བམ་དང་། སྣག་ཚ་དང་། སྨྱུག་གུ་ལ་སོགས་པའི་སྦྱིན་པ་བྱེད་པ་དང་། ཆང་མི་འཐུང་བ་སྟེ་།
K10mkarmviu:303	 pibati. yathoktaṃ ca nandikasūtre. pañcatriṃśad madyapānadoṣā akuśalapakṣeṇa yojayitavyāḥ.	K10Dx_H0344:460b-3	དཔེར་ན་། དགའ་བོའི་མདོ་ལས་། ཆང་གི་ཉེས་པ་སུམ་ཅུ་རྩ་ལྔ་གསུངས་པ་དགེ་བའི་ཕྱོགས་སུ་སྦྱར་བ་ལྟ་བུ་སྟེ་།
K10mkarmviu:304	 idaṃ karma mahāprajñasaṃvartanīyam.	K10Dx_H0344:460b-5	ལས་དེ་ལྟ་བུ་ནི་ཤེས་རབ་ཆེ་བར་འགྱུར་བའོ་༎
K10mkarmviu:305	 XV. tatra katamat karma narakopapattisaṃvartanīyam. ucyate. tīvraṃ praduṣṭacittasya  kāyavāṅmanoduścaritam. ucchedadṛṣṭiḥ. śāśvatadṛṣṭiḥ. nāstikadṛṣṭiḥ. akriyādṛṣṭiḥ.	K10Dx_H0344:460b-6	དེ་ལ་སེམས་ཅན་དམྱལ་བར་སྐྱེ་བར་འགྱུར་བའི་ལས་ཡོད་དེ་། དེ་གང་ཞེ་ན་། དེ་ནི་ཤིན་ཏུ་ཞེ་སྡང་བའི་སེམས་ཀྱིས་ལུས་དང་། ངག་དང་། ཡིད་ཀྱི་ཉེས་པ་ཆེར་བྱས་པ་དང་། ཆད་པར་ལྟ་བ་དང་། རྟག་པར་ལྟ་བ་དང་། མེད་པར་ལྟ་བ་དང་། སེར་སྣ་ཆེ་བ་དང་། དྲིན་དུ་མི་གཟོ་བ་དང་།
K10mkarmviu:307	 matsarivādaḥ. akṛtajñatā. ānantaryam. āryāṇāṃ śīlavatām abhūtābhyākhyānadānam. idaṃ	K10Dx_H0344:460b-9	མཚམས་མེད་པའི་ལས་བྱེད་པ་དང༏་འཕགས་པ་དང་ཚུལ་ཁྲིམས་དང་ལྡན་པ་རྣམས་ལ་སྐུར་པ་འདེབས་པ་སྟེ་།
K10mkarmviu:308	 karma narakopapattisaṃvartanīyam.	K10Dx_H0344:460b-10	ལས་དེ་ལྟ་བུ་ནི་སེམས་ཅན་དམྱལ་བར་སྐྱེ་བར་འགྱུར་རོ་༎
K10mkarmviu:309	 XVI. tatra katamat karma tiryagyonyupapattisaṃvartanīyam. ucyate. madhyamaṃ kāyavāṅmanoduścaritaṃ	K10Dx_H0344:461a-0	དེ་ལ་དུད་འགྲོའི་སྐྱེ་གནས་སུ་༄༤༦༡ཨ་༌༎ སྐྱེ་བར་འགྱུར་བའི་ལས་ཡོད་དེ་། དེ་གང་ཞེ་ན་།
K10mkarmviu:310	 vicitraṃ rāgasamutthitaṃ karma vicitraṃ dveṣasamutthitaṃ karma vicitraṃ mohasamutthitaṃ	K10Dx_H0344:461a-3	ལུས་དང་། ངག་དང་། ཡིད་ཀྱིས་ཉེས་པ་འབྲིང་དུ་བྱས་པ་དང་། འདོད་ཆགས་ལས་བྱུང་བའི་ལས་སྣ་ཚོགས་དང་། ཞེ་སྡང་ལས་བྱུང་བའི་ལས་སྣ་ཚོགས་དང་། གཏི་མུག་ལས་བྱུང་བའི་ལས་སྣ་ཚོགས་དང་། ཕ་མ་དང་།
K10mkarmviu:311	 karma. mātāpitroḥ pravrajitānāṃ cākalpikapradānam. tiryagyonigatānāṃ satvānām avahasanam.	K10Dx_H0344:461a-4	རབ་ཏུ་བྱུང་བ་རྣམས་ལ་ཚུལ་དང་མི་འདྲ་བའི་སྦྱིན་པར་བྱེད་པ་དང་། དུད་འགྲོའི་སྐྱེ་གནས་སུ་སྐྱེས་པའི་སེམས་ཅན་རྣམས་ལ་ཕྱས་བྱེད་པ་དང་། དེ་ལྟར་སྨོན་པ་སྟེ་།
K10mkarmviu:312	 tathā praṇidhānakarma yathā govratikakukkuravratikaprabhṛtīnāṃ praṇidhānam atropapadyeyam iti.  a) yathā ca bodhisatvasya siṃha jātake 'vadānaṃ vaktavyam. yathā ca varṣākārasya brāhmaṇasya markaṭopapattiḥ. tadyathā (MKV 45)	K10Dx_H0344:461a-5	དཔེར་ན་། བ་ལང་གི་བརྟུལ་ཞུགས་ཅན་དང་། བྱའི་བརྟུལ་ཞུགས་ཅན་ལ་སོགས་པ་དེ་ལྟར་སྐྱེ་བར་ཤོག་ཅིག་ཅེས་སྨོན་པ་རྣམས་དང་། བྱང་ཆུབ་སེམས་དཔའི་ཆེད་དུ་བརྗོད་པ་སེང་གེའི་སྐྱེས་པའི་རབས་ལས་བྱུང་བ་དང་། བྲམ་ཟེ་ཆར་འབེབས་སྤྲེའུར་སྐྱེས་པར་གྱུར་པ་སྟེ་།
K10mkarmviu:314	 varṣākāreṇa brāhmaṇena sthaviramahākāśyapo bhikṣū rājagṛhasyoparimeṇa gṛdhrakūṭāt  parvatād ṛṣigiripārśvaṃ vihāyasā gacchan dṛṣṭaḥ. tena praduṣṭacittena devadattājātaśatrusaṃsargād	K10Dx_H0344:461a-6	དཔེར་ན་། བྲམ་ཟེ་ཆར་འབེབས་ཀྱིས་གནས་བརྟན་འོད་སྲུང་ཆེན་པོ་བྱ་རྒོད་ཕུང་པོའི་རི་ལ་། རྒྱལ་པོའི་ཁབ་ཀྱི་སྟེང་ནས་ནམ་མཁའ་ལ་འགྲོ་བ་མཐོང་ནས་། ལྷས་བྱིན་དང་མ་སྐྱེས་དགྲའི་བསྟེན་ལས་ཞེ་སྡང་བའི་སེམས་སུ་གྱུར་ཏེ་།
K10mkarmviu:316	 vāgduścaritaṃ kṛtam. eṣa śramaṇo vihāyasā gacchan parvatāt parvataṃ gacchati. tadyathā	K10Dx_H0344:461a-9	དགེ་སློང་འདི་ནི་རི་ལས་རིར་། ནམ་མཁའ་ལས་ནམ་མཁར་། སྤྲེའུ་ཤིང་ལས་ཤིང་གི་སྟེང་དུ་འཛེག་པ་དང་འདྲ་བར་འགྲོའོ་ཞེས་མི་སྙན་པའི་ཚིག་ཏུ་བརྗོད་པ་དེ་བཅོམ་ལྡན་འདས་ལ་གསོལ་ཏོ་༎
K10mkarmviu:318	 vāgduścaritaṃ kṛtam. tasya ko vipākaḥ. bhagavān āha. asya vāgduścaritasya vipākato	K10Dx_H0344:461b-1	བཙུན་པ་བཅོམ་ལྡན་འདས་། དེའི་རྣམ་པར་སྨིན་པ་ཅིར་འགྱུར་ཞེས་ཞུས་པ་དང་། བཅོམ་ལྡན་འདས་ཀྱིས་བཀའ་སྩལ་པ་།
K10mkarmviu:319	 varṣākāro brāhmaṇaḥ pañca janmāntaraśatāni markaṭo bhaviṣyatīti. tatas tena varṣākāreṇa  śrutaṃ bhagavatā nirdiṣṭatvaṃ kila pañca janmāntaraśatāni markaṭo bhaviṣyatīti. sa	K10Dx_H0344:461b-3	ངན་དུ་བརྗོད་པ་དེའི་རྣམ་པར་སྨིན་པས་བྲམ་ཟེ་ཆར་འབེབས་འདི་། ཚེ་རབས་ལྔ་བརྒྱའི་བར་དུ་སྤྲེའུར་འགྱུར་རོ་ཞེས་བཀའ་སྩལ་པ་དང་། དེ་མི་དགའ་བའི་སེམས་ཀྱིས་དད་པའི་སེམས་བསྐྱེད་དེ་། དེས་བཅོམ་ལྡན་འདས་མྱ་ངན་ལས་འདའ་ཀར་།
K10mkarmviu:321	 saṃvignacittaṃ prasāditavān. tena bhagavān parinirvāṇakāle pṛṣṭaḥ. tasya karmaṇaḥ	K10Dx_H0344:461b-6	བཅོམ་ལྡན་འདས་།
K10mkarmviu:322	 kadā parikṣaya iti. bhagavān āha. tāny eva pañca janmāntaraśatāni kiṃ tu rājagṛhe	K10Dx_H0344:461b-7	སུག་ལས་དེ་གང་དུ་བས་པར་འགྱུར་ཞེས་ཞུས་པ་དང་། བཅོམ་ལྡན་འདས་ཀྱིས་བཀའ་སྩལ་པ་། ཚེ་རབས་ལྔ་བརྒྱ་པོ་དེ་དག་གིས་ཟད་པར་འགྱུར་བར་ཟད་དེ་།
K10mkarmviu:323	 utpatsyase yathā jambvā jambudvīpe jāyate. yatroṣṭrikāmātrāṇi phalāni. yathā kṣaudramadhv	K10Dx_H0344:461b-9	ཅུང་ཟད་དུ་ན་འཛམ་བུའི་གླིང་གི་ཤིང་འཛམ་བུ་ཞེས་བྱ་བ་ཤིང་ཏོག་ལྔ་བརྒྱ་ཙམ་ཡོད་པ་།
K10mkarmviu:324	 aneḍakam evamāsvādāni. (MKV 46)	K10Dx_H0344:461b-10	ཤིང་ཏོག་དེ་དག་ཀྱང་སྦྲང་རྩི་ལྟར་མངར་ཞིང་གཏང་མི་བྲ་བར་ཞིམ་པ་དང་ལྡན་པ་དེའི་དྲུང་དུ་སྐྱེས་ཏེ་།
K10mkarmviu:325	 tatropapattir bhaviṣyati. tato vyutthitasya te sugatir bhaviṣyati. yathā cittapradūṣaṇena siṃheṣūpapannaḥ. tadarthaṃ ca bhagavatā gāthā bhāṣitā.	K10Dx_H0344:461b-11	དེ་ནས་རྒྱལ་པོ་ཁབ་ཏུ་སྐྱེས་ནས་ཚེ་འཕོས་ཏེ་ཐར་པ་དང་མཐོ་རིས་སུ་སྐྱེ་བར་འགྱུར་རོ་ཞེས་གསུངས་པ་ལྟ་བུ་དང་། དཔེར་ན་། ཞེ་སྡང་གི་སེམས་ཀྱིས་སེང་གེའི་ནང་དུ་སྐྱེས་ནས་དེའི་དོན་དུ་བཅོམ་ལྡན་འདས་ཀྱིས་ཚིགས་སུ་བཅད་པ་གསུངས་པ་།
K10mkarmviu:326	 dīrghā jāgarato rātrir dīrghaṃ śrāntasya yojanam	K10Dx_H0344:461b-13	མེལ་ཚེ་བྱེད་ན་ནམ་ཡང་རིང་༎ ངལ་བ་དག་ལ་དཔག་ཚད་རིང་༎
K10mkarmviu:327	 dīrgho bālasya saṃsāraḥ saddharmam avijānataḥ.	K10Dx_H0344:461b-15	དམ་པའི་ཆོས་ནི་ཤེས་གྱུར་ཀྱང་༎ ༄༤༦༢ཨ་༌༎ བྱིས་པ་རྣམས་ལ་འཁོར་བ་རིང་༎
K10mkarmviu:328	 idaṃ karma tiryagyonyupapattisaṃvartanīyam.	K10Dx_H0344:462a-2	ལས་དེ་ལྟ་བུ་ནི་དུད་འགྲོའི་སྐྱེ་གནས་སུ་སྐྱེ་བར་འགྱུར་བའོ་༎
K10mkarmviu:329	 XVII. tatra katamat karma yamalokopapattisaṃvartanīyam. ucyate. kruddhasya pratihatacittasya  kāyavāṅmanoduścaritam. lobho viṣamalobho mithyājīvo jighāṃsitapipāsitasya kruddhasya	K10Dx_H0344:462a-3	དེ་ལ་གཤིན་རྗེའི་འཇིག་རྟེན་དུ་སྐྱེ་བར་འགྱུར་བའི་ལས་ཡོད་དེ་། དེ་གང་ཞེ་ན་། དེ་ནི་ཁྲོ་ཞིང་ཞེ་སྡང་བའི་སེམས་ཀྱིས་ལུས་དང་། ངག་དང་། ཡིད་ཀྱིས་ངན་དུ་སྤྱད་པ་དང་། འདོད་ཆགས་དང་མི་རིགས་པར་འདོད་པས་ལོག་པར་འཚོ་བ་དང་། བཀྲེས་ཤིང་སྐོམ་པ་དང་། ཁྲོས་བཞིན་དུ་ཚེ་འཕོས་པ་དང་།
K10mkarmviu:332	 a) yathā coktaṃ bhagavatā śatavarge āgame karmavibhaṅgasūtre. (MKV 47)	K10Dx_H0344:462a-7	བརྒྱ་བསྡུས་པའི་མདོ་ལས་། བཅོམ་ལྡན་འདས་ཀྱིས་ཀུན་དགའ་བོ་ལ་བཀའ་སྩལ་པ་།
K10mkarmviu:333	 tasya khalu punar ānanda pudgalasyānyajātikṛtaṃ vā karma pratyupasthitaṃ bhavati. maraṇakāle vā mithyādṛṣṭiḥ. idaṃ karma yamalokopapattisaṃvartanīyam.	K10Dx_H0344:462a-9	ཀུན་དགའ་བོ་། གང་ཟག་ལ་ལ་ཚེ་རབས་སྔ་མ་ལ་བྱས་པའི་ལས་ཉེ་བར་གནས་པར་གྱུར་ཏམ་། ལས་དེ་ལྟ་བུ་ནི་གཤིན་རྗེའི་འཇིག་རྟེན་དུ་སྐྱེ་བར་འགྱུར་བའོ་༎ དེ་ལ་ལྷ་མ་ཡིན་གྱི་འཇིག་རྟེན་དུ་སྐྱེ་བར་འགྱུར་བའི་ལས་ཡོད་དེ་། དེ་གང་ཞེ་ན་།
K10mkarmviu:334	 XVIII. tatra katamat karmāsuralokopapattisaṃvartanīyam. ucyate. sarvamṛdukāyavāṅmanoduścaritam.	K10Dx_H0344:462a-15	དེ་ནི་ལུས་དང་། ངག་དང་། ཡིད་ཀྱིས་ཉེས་པ་ཆུང་དུ་སྦྱང་བ་དང་། ང་རྒྱལ་དང་། མངོན་པའི་ང་རྒྱལ་དང་། ངའོ་ཞེས་པའི་ང་རྒྱལ་དང་། ཆུང་བའི་ངན་རྒྱལ་དང་། ལེགས་པ་སྤྱད་པའི་དགེ་བའི་རྩ་བ་དེར་བསྔོས་པ་དང་། ཤེས་རབ་ཀྱི་སྒོ་ནས་འདོད་ཆགས་ཀུན་གྱི་༄༤༦༢བ་རབ་ལས་བྱུང་བའི་ཚུལ་ཁྲིམས་ངན་པ་སྤྱད་པ་སྟེ་། ལས་དེ་ལྟ་བུ་ནི་ལྷ་མ་ཡིན་གྱི་འཇིག་རྟེན་དུ་སྐྱེ་བར་འགྱུར་བའོ་༎ དེ་ལ་མིར་སྐྱེ་བར་འགྱུར་བའི་ལས་ཡོད་དེ་། དེ་གང་ཞེ་ན་།
K10mkarmviu:336	 sarvotkṛṣṭarāgasamutthitaṃ dauḥśīlyaṃ prajñāmukhena. idaṃ karmāsuralokopapattisaṃvartanīyam.	K10Dx_H0344:462b-8	མི་དགེ་བའི་ལས་བཅུ་པོ་དེ་དག་སྤོང་བ་སྟེ་། ལས་དེ་ལྟ་བུ་ནི་མིར་སྐྱེ་བར་འགྱུར་བའོ་༎ དེ་ལ་འདོད་པའི་ཁམས་ན་སྤྱོད་པའི་ལྷར་སྐྱེ་བར་འགྱུར་བའི་ལས་ཡོད་དེ་།
K10mkarmviu:337	 XIX. tatra katamat karma manuṣyalokopapattisaṃvartanīyam. ucyate. subhāvitā mandabhāvitāś  ca daśa kuśalāḥ karmapathāḥ. katame daśa. trividhaṃ kāyakarma. caturvidhaṃ vākkarma.	K10Dx_H0344:462b-11	དེ་གང་ཞེ་ན་། དེ་ནི་དགེ་བ་བཅུའི་ལས་ཀྱི་ལམ་ཡོངས་སུ་རྫོགས་ཤིང་ལེགས་པར་སྦྱངས་པ་སྟེ་། ལས་དེ་ལྟ་བུ་ནི་འདོད་པའི་ཁམས་ན་སྤྱོད་པའི་ལྷར་སྐྱེ་བར་འགྱུར་བའོ་༎ དེ་ལ་གཟུགས་ཀྱི་ཁམས་ན་སྤྱོད་པའི་ལྷར་སྐྱེ་པར་གྱུར་བའི་ལས་ཡོད་དེ་།
K10mkarmviu:340	 XX. tatra katamat karma kāmāvacaradevopapattisaṃvartanīyam. ucyate. susamāptā daśa kuśalāḥ karmapathāḥ. idaṃ karma kāmāvacaradevopapattisaṃvartanīyam.  XXI. tatra katamat karma rūpāvacaradevopapattisaṃvartanīyam. ucyate. susamāptāḥ susamāhitās  tato viśiṣṭatarāḥ paripūrṇā daśa kuśalāḥ karmapathāḥ. idaṃ karma rūpāvacaradevopapattisaṃvartanīyam.	K10Dx_H0344:462b-16	དགེ་བ་བཅུའི་ལས་ཀྱི་ལམ་རྣམས་ལེགས་པར་སྦྱངས་ཤིང་ཤིན་ཏུ་མཉམ་པར་བཞག་པ་དང་། ཁྱད་པར་དུ་ཤིན་ཏུ་འཕགས་པ་དང་། ཡོངས་སུ་རྫོགས་པར་བྱས་པ་སྟེ་། ལས་དེ་ལྟ་བུ་ནི་གཟུགས་ཀྱི་ཁམས་ན་སྤྱོད་༄༤༦༣ཨ་༌༎ པའི་ལྷར་སྐྱེ་པར་འགྱུར་བའོ་༎ དེ་ལ་གཟུགས་མེད་པའི་ཁམས་ན་སྤྱོད་པའི་ལྷར་སྐྱེ་བར་འགྱུར་བའི་ལས་ཡོད་དེ་། དེ་གང་ཞེ་ན་། གཟུགས་མེད་པའི་སྙོམས་པར་འཇུག་པ་བཞི་སྟེ་།
K10mkarmviu:345	 etāḥ samāpattayo bhāvitā bahulīkṛtāś ca bhavanti. idaṃ karmārūpyāvacaradevopapattisaṃvartanīyam.	K10Dx_H0344:463a-10	ལས་དེ་ལྟ་བུ་ནི་གཟུགས་མེད་པའི་ཁམས་ལ་སྤྱོད་པའི་ལྷར་སྐྱེ་བར་འགྱུར་བའོ་༎ དེ་ལ་བྱས་ལ་མ་བསགས་པའི་ལས་ཡོད་དེ་།
K10mkarmviu:346	 XXIII. tatra katamat karma kṛtaṃ nopacitam. ucyate. yat kṛtvā karma āstīryati jihreti vigarhati vijugupsati deśayati ācaṣṭe vyaktīkaroti. (MKV	K10Dx_H0344:463a-12	དེ་གང་ཞེ་ན་། ༄༤༦༣བ་བྱས་ནས་ངོ་ཚ་བར་འཛིན་པ་དང་། འགྱོད་པ་དང་། སྨོད་པ་དང་། འཆགས་པ་དང་། མཐོལ་བ་དང་། སྤོང་བ་དང་། ཕྱིན་ཆད་མི་བྱེད་པར་སྡོམ་པ་སྟེ་།
K10mkarmviu:347	 āyatyāṃ saṃvaram āpadyate. na punaḥ karoti. idaṃ karma kṛtaṃ nopacitam.	K10Dx_H0344:463b-1	ལས་དེ་ལྟ་བུ་ནི་བྱས་ལ་མ་བསགས་པའོ་༎ དེ་ལ་བསགས་ལ་མ་བྱས་པའི་ལས་ཡོད་དེ་།
K10mkarmviu:348	 XXIV. tatra katamat karmopacitaṃ na kṛtam. ucyate. yat karma kāyena paripūrayitavyam. tatra praduṣṭacitto vācaṃ bhāṣate evaṃ te kariṣyāmīti. idaṃ karmopacitaṃ na kṛtam.  XXV. tatra katamat karma kṛtaṃ copacitaṃ ca. ucyate. yat karma sāṃcetanikam.	K10Dx_H0344:463b-3	དེ་གང་ཞེ་ན་། ལས་གང་ལུས་ཀྱིས་ཡོངས་སུ་རྫོགས་པར་བྱས་པ་སྟེ་། སེམས་ཀྱིས་ཡོངས་སུ་རྫོགས་པར་བྱས་ཤིང་ཚིག་ཏུ་ཡང་ལས་འདི་བྱའོ་ཞེས་སྨྲས་ལ་དེ་མ་བྱས་པ་སྟེ་། ལས་དེ་ལྟ་བུ་ནི་བསགས་ལམ་བྱས་པའོ་༎ དེ་ལ་བྱས་ཀྱང་བྱས་ལ་བསགས་ཀྱང་བསགས་པའི་ལས་ཡོད་དེ་།
K10mkarmviu:357	 idaṃ karma kṛtaṃ copacitaṃ ca.	K10Dx_H0344:463b-10	ལས་དེ་ལྟ་བུ་ནི་བྱས་ཀྱང་བྱས་ལ་བསགས་ཀྱང་བསགས་སོ་༎
K10mkarmviu:358	 XXVI. tatra katamat karma naiva kṛtaṃ naivopacitam. ucyate. yat karma sāṃcetanikaṃ svapnāntare kṛtaṃ kāritaṃ vā. idaṃ karma naiva kṛtaṃ naivopacitam.	K10Dx_H0344:463b-11	དེ་ལ་བྱས་ཀྱང་མ་བྱས་ལ་བསགས་ཀྱང་མ་བསགས་པའི་ལས་ཡོད་དེ་། དེ་གང་ཞེ་ན་། ལས་གང་ཆེད་དུ་མ་བསགས་པར་བྱས་པ་། རྨི་ལམ་ན་བྱས་པའམ་བྱེད་དུ་བཅུག་པ་ལྟ་བུ་སྟེ་། ལས་དེ་ལྟ་བུ་ནི་བྱས་ཀྱང་མ་བྱས་ལ་བསགས་ཀྱང་མ་བསགས་པའོ་༎
K10mkarmviu:359	 XXVII. tatra katamat karma yena samanvāgataḥ pudgalo narakeṣūpapannaḥ paripūrṇaṃ nairayikam āyuḥ kṣapayitvā cyavati. ucyate. (MKV 49)	K10Dx_H0344:464a-0	ལས་གང་དང་ལྡན་ན་གང་ཟག་སེམས་ཅན་དམྱལ་བར་སྐྱེས་ནས་སེམས་ཅན་དམྱལ་བའི་ཚེ་ཡོངས་སུ་རྫོགས་པར་ཟད་པར་བྱས་ནས་ཚེ་འཕོ་བར་༄༤༦༤ཨ་༌༎ འགྱུར་བའི་ལས་ཡོད་དེ་། དེ་གང་ཞེ་ན་།
K10mkarmviu:360	 ihaikatyena narakīyaṃ karma kṛtaṃ bhavaty upacitam. sa tat karma kṛtvā nāstīryati.  na jihrīyati na vigarhati na jugupsati na deśayati nācaṣṭe na vyaktīkaroti nāyatyāṃ	K10Dx_H0344:464a-3	འདི་ནི་ལ་ལ་ཞིག་གིས་སེམས་ཅན་དམྱལ་བའི་ལས་བྱས་ཤིང་བསགས་ཀྱང་ལས་དེ་བྱས་པས་ངོ་ཚར་མི་འཛིན་། མི་འགྱོད་། མི་སྨོད་པ་དང་། མི་འཆགས་། མི་མཐོལ་ཞིང་།
K10mkarmviu:362	 saṃvaram āpadyate bhūyasyā mātrayā hṛṣyati. prītim utpādayati. yathā devadattakokālikādayaḥ.	K10Dx_H0344:464a-6	ཕྱིན་ཆད་མི་སྡོམ་ལ་ཕྱིར་ཞིང་དགའ་བ་དང་། ཉམས་བདེ་བ་སྐྱེད་པ་སྟེ་། དཔེར་ན་། ལྷས་བྱིན་དང་། དུས་མིན་ལ་སོགས་པ་ལྟ་བུ་སྟེ་།
K10mkarmviu:363	 idaṃ karma yena samanvāgataḥ pudgalo narakeṣūpapannaḥ paripūrṇanairayikam āyuḥ kṣapayitvā cyavati.	K10Dx_H0344:464a-8	ལས་དེ་ལྟ་བུ་དང་ལྡན་ན་གང་ཟག་དེ་སེམས་ཅན་དམྱལ་བའི་ཚེ་ཡོངས་སུ་རྫོགས་ནས་ཚེ་འཕོ་བར་འགྱུར་བའོ་༎
K10mkarmviu:364	 XXVIII. tatra katamat karma yena samanvāgataḥ pudgalo narakeṣūpapanno 'rdhanairayikam	K10Dx_H0344:464a-9	དེ་ལ་ལས་གང་དང་ལྡན་ན་གང་ཟག་སེམས་ཅན་དམྱལ་བར་སྐྱེས་ནས་། སེམས་ཅན་དམྱལ་བའི་ཚེ་ཕྱེད་ཟད་དེ་ཚེ་འཕོ་བར་འགྱུར་བའི་ལས་ཡོད་དེ་། དེ་གང་ཞེ་ན་།
K10mkarmviu:365	 āyuḥ kṣapayitvā cyavati. ucyate. ihaikatyena nārakīyaṃ karma kṛtaṃ bhavaty upacitam.  sa tat kṛtvā nāstīryati na jihrīyati na vigarhati na jugupsate na deśayati nācaṣṭe  na vyaktīkaroti. nāyatyāṃ saṃvaram āpadyate. api tu na bhūyasyā mātrayā hṛṣyati.	K10Dx_H0344:464a-12	དེ་ནི་འདི་ལ་ལ་ལས་སེམས་ཅན་དམྱལ་བར་འགྱུར་བའི་ལས་བྱས་ནས་འཛེམ་པ་དང་། འགྱོད་པ་དང་། སྨོད་པ་དང་། འཆགས་པ་དང་། མཐོལ་བ་དང་། འདོར་བ་དང་། སྤོང་བ་དང༏་ཕྱིན་ཆད་སྡོམ་པར་བྱེད་པ་སྟེ་།
K10mkarmviu:368	 na pritim utpādayati. idaṃ karma yena samanvāgataḥ pudgalo narakeṣūpapanno 'rdhanairayikam  āyuḥ kṣapayitvā cyavati.  XXIX. tatra katamat karma yena samanvāgataḥ pudgalo narakeṣūpapannamātra eva cyavati.	K10Dx_H0344:464a-13	འདི་ནི་ལས་གང་དང་ལྡན་ན་གང་ཟག་སེམས་ཅན་དམྱལ་བར་སྐྱེ་སྟེ་། སེམས་ཅན་དམྱལ་བའི་ཚེ་ཕྱེད་ཟད་པར་བྱས་ནས་ཚེ་འཕོ་བར་འགྱུར་བའོ་༎ དེ་ལ་ལས་གང་དང་ལྡན་ན་གང་ཟག་སེམས་ཅན་དམྱལ་བར་སྐྱེས་མ་ཐག་ཏུ་ཚེ་འཕོ་བར་འགྱུར་བའི་ལས་ཡོད་དེ་།
K10mkarmviu:371	 ucyate. ihaikatyena nārakīyaṃ karma kṛtaṃ bhavaty upacitaṃ ca. sa tat kṛtvāstīryati.  jihrīyati. vigarhati vijugupsati ācaṣṭe. deśayati. vyaktīkaroti. āyatyāṃ saṃvaram	K10Dx_H0344:464a-16	དེ་གང་ཞེ་ན་། དེ་ནི་འདི་ལ་གང་ཟག་༄༤༦༤བ་ལ་ལས་སེམས་ཅན་དམྱལ་བའི་ལས་བྱས་ཤིང་བསགས་པར་ན་། ལས་དེ་བྱས་པས་ངོ་ཚ་བར་འཛིན་ལ་འགྱོད་ཅིང་སྨོད་པ་དང་། འཆགས་ཤིང་མཐོལ་ན་ཕྱིན་ཆད་མི་བྱའོ་ཞེས་སྡོམ་པར་བྱེད་པས་།
K10mkarmviu:373	 āpadyate. na punaḥ kurute. sa cen narakeṣūpapadyate upapannamātra eva cyavati.	K10Dx_H0344:464b-2	བརྒྱ་ལ་སེམས་ཅན་དམྱལ་བར་སྐྱེས་ནའང་སྐྱེས་མ་ཐག་ཏུ་ཚེ་འཕོ་བར་འགྱུར་བ་སྟེ་།
K10mkarmviu:374	 a) yathā rājājātaśatruḥ. tena devadattasahāyenānantaryakarma kṛtam. pitṛvadhaḥ. saṃghabhedaḥ.  dhanapālamokṣaṇam. śilāyantramokṣaṇaṃ devadattasyādeśena. tasmād avīcinarakagamanaṃ	K10Dx_H0344:464b-3	དཔེར་ན་། རྒྱལ་པོ་མ་སྐྱེས་དགྲས་མཚམས་མེད་པའི་ལས་ཕ་བསད་པ་དང་། དགེ་འདུན་ཕྱེ་བ་དང་། གླང་པོ་ཆེ་བཀྱེ་བ་དང་། རྡོའི་འཁོར་ལོ་འཕངས་པ་ལྟ་བུ་སྟེ་།
K10mkarmviu:376	 śrutvā tena saṃvignena bhagavati cittaṃ prasāditam. śrāmaṇyaphalasūtre 'tyayadeśanaṃ	K10Dx_H0344:464b-4	ལས་དེས་མནར་མེད་པའི་སེམས་ཅན་དམྱལ་བར་འགྲོ་བར་ཐོས་ནས་དེ་མི་དགའ་སྟེ་།
K10mkarmviu:377	 kṛtam. pratisaṃdadhāti kuśalamūlāni. tena maraṇakāle cittaṃ prasāditam. asthibhir	K10Dx_H0344:464b-5	སེམས་མོས་པར་བྱས་པ་དང་། དགེ་སྦྱོང་གི་འབྲས་བུའི་མདོ་ལས་སྡིག་བཤགས་ཏེ་། དགེ་བའི་རྩ་བ་བསགས་པ་དང་། ཚེ་འཕོ་ཀར་རུས་པ་ཡན་ཆད་ཀྱང་སངས་རྒྱས་ལ་སྐྱབས་སུ་མཆིའོ་༎ དེ་སྐད་དུ་།
K10mkarmviu:380	 XXX. tatra katamat karma niyatopapattisaṃvartanīyam. ucyate. yat kṛtvā kvacid upapattau pariṇāmayati amutropapadyeyam iti. sa tatropapadyate.	K10Dx_H0344:464b-14	དེ་ལ་ངེས་པར་སྐྱེ་བར་འགྱུར་བའི་ལས་ཡོད་དེ་། དེ་གང་ཞེ་ན་། དེ་ནི་ལས་བྱས་ནས་ཆེ་གེ་མོ་ཞིག་ཏུ་སྐྱེ་བར་ཤོག་ཅིག་ཅེས་ཡོངས་སུ་བསྔོས་༄༤༦༥ཨ་༌༎ པས་དེར་སྐྱེས་པར་འགྱུར་བ་སྟེ་།
K10mkarmviu:381	 yathā bhagavato jātake śyāmākajātakaprabhṛtiṣu praṇidhānavaśād upapattir varṇyate. idaṃ karma niyatopapattisaṃvartanīyam.	K10Dx_H0344:465a-2	དཔེར་ན་། བཅོམ་ལྡན་འདས་ཀྱིས་དཀར་ཤམ་གྱི་སྐྱེས་པའི་རབས་ལས་སྨོན་ལམ་གྱི་དབང་གིས་སྐྱེ་བར་གསུངས་པ་ལྟ་བུ་སྟེ་། ལས་དེ་ལྟ་བུ་ནི་ངེས་པར་སྐྱེ་བར་འགྱུར་པའོ་༎
K10mkarmviu:382	 XXXI. tatra katamat karmāniyatopapattisaṃvartanīyam. ucyate. yat kṛtvā na kvacid  upapattau pariṇāmayati amutropapadyeyam iti. yathā satvāḥ karmavaśād upapadyante.	K10Dx_H0344:465a-4	དེ་ལ་མ་ངེས་པར་སྐྱེ་བར་འགྱུར་བའི་ལས་ཡོད་དེ་། དེ་གང་ཞེ་ན་། དེ་ནི་ལས་བྱས་ནས་ཆེ་གེ་མོ་ཞིག་ཏུ་ཤོག་ཅིག་ཅེས་ཡོངས་སུ་མི་བསྔོ་བ་སྟེ་།
K10mkarmviu:384	 idaṃ karmāniyatopapattisaṃvartanīyam.	K10Dx_H0344:465a-7	ལས་དེ་ལྟ་བུ་ནི་མ་ངེས་པར་སྐྱེ་བར་འགྱུར་པའོ་༎
K10mkarmviu:385	 XXXII. tatra katamat karma deśāntaravipākam ucyate. yat karma tasminn eva janmāntare  vā deśāntaragatasya vipacyate śubham aśubhaṃ vā. tat karma deśāntaravipākam. yathā	K10Dx_H0344:465a-8	དེ་ལ་ཡུལ་གཞན་དུ་རྣམ་པར་སྨིན་པར་འགྱུར་བའི་ལས་ཡོད་དེ་། དེ་གང་ཞེ་ན་། དེ་ནི་ཚེ་འདི་ཉིད་དམ་། ཚེ་གཞན་ལ་ཡུལ་གཞན་དུ་བདེ་བའམ་། མི་བདེ་བ་རྣམ་པར་སྨིན་པ་སྟེ་། དཔེར་ན་། བཅོམ་ལྡན་འདས་ཀྱིས་བཀའ་སྩལ་པ་།
K10mkarmviu:387	 bhagavān kathayati. bhūtapūrvaṃ bhikṣavo jambudvīpe manuṣyāṇam aparimāṇam āyur bhavati.	K10Dx_H0344:465a-14	དགེ་སློང་དག་། སྔོན་འདས་པའི་དུས་ན་འཛམ་བུའི་གླིང་གི་མིའི་ཚེ་དཔག་ཏུ་མེད་དེ་།
K10mkarmviu:388	 yathā rājño māndhātuḥ. athānyatarasmin nagare maitrāyajño nāma (MKV 51)  sārthavāhaputro babhūva. sa pañcaśatasahāyaparivṛta udyānaṃ gataḥ. taiś ca sahāyair	K10Dx_H0344:465a-16	རྒྱལ་པོ་མན་ད་ཏ་ལྟར་གྱུར་པའི་ཚེ་། གྲོང་ཁྱེར་གཅིག་ཅིག་ན་དེད་དཔོན་གྱི་བུ་བྱམས་པ་མཆོད་སྦྱིན་ཞེས་བྱ་བ་ཞིག་ཡོད་པ་གྲོགས་ལྔ་བརྒྱ་ཙམ་གྱིས་བསྐོར་ཏེ་།
K10mkarmviu:390	 uktaḥ. asmin nagare baṇijas tava pitaraṃ pūrvaṅgamaṃ kṛtvā mahāsamudram avatīrya	K10Dx_H0344:465a-18	བཟའ་ཤིང་གི་ར་བར་ཕྱིན་པ་དང་། གྲོགས་པོ་དེ་དག་གིས་སྨྲས་པ་། གྲོང་འདི་ན་ཁྱོད་ཀྱི་ཕ་ལ་སོགས་པ་ཚོད་པ་རྣམས་རྒྱ་མཚོ་ལས་རྒྱུ་ཞིང་།
K10mkarmviu:391	 suvarṇabhūmiprabhṛtīni deśāntarāṇi gatvā dvīpāntarāṇi ca paśyanti. dravyopārjanaṃ	K10Dx_H0344:465a-20	གསེར་གནས་ལ་སོགས་པ་ཡུལ་གཞན་དག་ཏུ་ཡང་འདོང་། གླིང་གཞན་དག་ཀྱང་ལྟ་ཞིང་ནོར་ལ་སོགས་པ་ཡང་བྱེད་ན་།
K10mkarmviu:392	 ca kurvanti. vayam api tvāṃ pūrvaṅgamaṃ kṛtvā samudram avatīrya dravyopārjanaṃ kariṣyāmo  dvīpāntarāṇi ca drakṣyāmaḥ. tatas tena evam iti pratiśrutam. sa rātrau gatvā mātaram	K10Dx_H0344:465b-0	ཁྱོད་ལ་སོགས་༄༤༦༥བ་པ་བདག་ཅག་ཀྱང་རྒྱ་མཚོ་ལས་རྒྱུས་ཏེ་ནོར་བསགས་པར་བྱའོ་ཞེས་སྨྲས་པ་དང་། དེས་དེ་ལྟར་བྱའོ་ཞེས་མཉན་ཏེ་དགོངས་མའི་གན་དུ་སོང་ནས་། མ་གསེར་གནས་སུ་འགྲོའོ་ཞེས་མ་ལ་དྲིས་པ་དང་། དེའི་མས་སྨྲས་པ་།
K10mkarmviu:394	 āpṛcchati. amba suvarṇabhūmiṃ gamiṣyāmaḥ. tasya mātāha. aparimāṇaṃ putra dravyaṃ	K10Dx_H0344:465b-2	བུ་། ནོར་ལྟ་ཞིག་ཁྱིམ་ན་དཔག་ཏུ་མེད་པ་ཡོད་ཀྱི་མ་འགྲོ་ཞིག་ཅེས་སྨྲས་པ་དང་། དེས་མའི་དག་མཉན་ཏེ་།
K10mkarmviu:395	 gṛhe tiṣṭhati. na gantavyam iti. sa mātur vacanena nivṛttaḥ. sa bhūya udyānaṃ gataḥ  sahāyair uktaḥ. tam arthaṃ vijñāpayāmaḥ. tena tathāstv iti pratiśrutam. sa bhūyo	K10Dx_H0344:465b-3	མི་འགྲོ་བར་བྱས་ནས་དེའི་འོག་ཏུ་བཟའ་ཤིང་གི་ར་བར་ཕྱིན་པ་དང་། གྲོགས་པོ་རྣམས་ཀྱིས་དོན་དེ་ཉིད་ལ་ད་དུང་ཡང་གསོལ་བ་འདེབས་སོ་ཞེས་སྨྲས་པ་དང་། དེས་དེ་ལྟར་བྱའོ་ཞེས་ནས་དེ་དག་གི་ངག་མཉན་ཏེ་།
K10mkarmviu:397	 mātaraṃ gatvāpṛcchati. bhūyaś ca mātrā pādapatanān nivartitaḥ. evaṃ tṛtīyam api.	K10Dx_H0344:465b-4	ཡང་སོང་ནས་མ་ལ་དྲིས་པ་དང་། མས་རྐང་པ་ནས་བཟུང་སྟེ་འདུག་པར་གྱུར་ནས་དེ་ལྟར་ལན་གསུམ་བྱས་པའི་འོག་ཏུ་བཟའ་ཤིང་གི་ར་བ་དེར་ཕྱིན་པ་དང་། གྲོགས་པོ་རྣམས་ཀྱིས་ངེས་པར་མི་འདོང་དུ་མི་རུང་ངོ་ཞེས་བསྒོ་ནས་། དེས་ཡང་མ་ལ་ཡུལ་གཞན་དུ་འགྲོའོ་ཞེས་ཞུས་པ་དང་། མས་བདོག་པ་ཐམས་ཅད་བསོག་ནས་རྐང་པ་ཡ་གཅིག་ནས་བཟུང་སྟེ་མི་འགྲོ་བར་བྱས་པ་ལས་།
K10mkarmviu:399	 udyānaṃ gatvā sahāyair uktaḥ. tava doṣād vayam api na gacchāmaḥ. pṛcchāmo vayam.	K10Dx_H0344:465b-6	དུས་གཞན་ཞིག་ན་ཁྱེའུ་དེ་བཟའ་ཤིང་གི་ར་བ་དེར་ཕྱིན་པ་དང་། གྲོགས་པོ་དག་གིས་སྨྲས་པ་། ཁྱོད་ཀྱིས་ཉེས་པས་བདག་ཅག་ཀྱང་ད་དུང་མ་དོང་སྟེ་།
K10mkarmviu:400	 trayodaśyāṃ gamiṣyāma iti. tena mātur aviditam eva bahir bahu bhāṇḍaṃ nirgamitam.  tasya gamanakāle prasthitasya mātā dvāre pādapatanaṃ kṛtvā sthitvā. putra na gantavyam	K10Dx_H0344:466a-0	ད་ནི་ཚེས་བཅུ་གསུམ་ལ་འདོང་ངོ་ཞེས་སྨྲས་པ་དང་། དེས་མ་ལ་མ་བྱས་པར་རྒྱ་རྫས་ཐམས་ཅད་ཕྱིར་བཏོན་ནས་དེ་ལམ་དུ་འཇུག་པར་བྱས་༄༤༦༦ཨ་༌༎ པ་དང་། དེའི་མས་སྒོ་ཁར་བསྡད་དེ་རྐང་པ་ནས་བཟུང་བ་དང་། བུ་།
K10mkarmviu:402	 iti. sa kruddho mātuḥ pādaṃ mastake dattvātikrāntaḥ samudrakūlaṃ ca gataḥ. tena sahāyā	K10Dx_H0344:466a-2	མ་འགྲོ་ཞིག་ཅེས་བྱས་པ་དང་། དེ་ཁྲོས་ནས་མའི་མགོ་ལ་འགོམས་ཏེ་སོང་ནས་རྒྱ་མཚོའི་ངོགས་སུ་ཕྱིན་པ་དང་། དེས་གྲོགས་པོ་རྣམས་ལ་བསྒོ་བ་།
K10mkarmviu:403	 uktāḥ. samudram avataratāṃ na jñāyate jīvitaṃ maraṇaṃ ca. vayaṃ sarva evāṣṭāṅgasamanvāgataṃ	K10Dx_H0344:466a-3	རྒྱ་མཚོར་འཇུག་པར་ནི་བྱ་ན་འཚོའམ་། མི་འཚོར་ཡང་གཏོལ་མེད་ཀྱི་བདག་ཅག་ཀུན་གྱིས་ཁྲིམས་བརྒྱད་གནོད་པར་བྱའོ་ཞེས་སྨྲས་ནས་།
K10mkarmviu:404	 poṣadhaṃ gṛhṇāmaḥ. tais tathāstv iti pratipannam. poṣadhaṃ ca gṛhītam. te samudram  avatīrṇāḥ. samudramadhyagatānāṃ ca teṣāṃ viṣamavātādyāhataḥ poto vinaṣṭas tena sarve	K10Dx_H0344:466a-5	དེ་དག་གིས་ཀྱང་དེའི་དག་མཉན་ཏེ་ཁྲིམས་མནོས་སོ་༎ དེ་ལྟར་དེ་དག་རྒྱ་མཚོར་ཞུགས་ཏེ་དོང་དོང་བ་ལས་དབུས་སུ་ཕྱིན་པ་དང་རླུང་ཆེན་པོ་ལངས་ནས་གྲུ་བུབ་སྟེ་།
K10mkarmviu:406	 kālagatāḥ. maitrāyajñaś ca ma. praṭamukhyān avabaddhaṃ tāmraghataṃ ca gṛhya samudrakūla  uttīrṇaḥ sa paryaṭamānaḥ sauvarṇaprākāraṃ nagaraṃ paśyati. ārāmasaṃpannaṃ vanasaṃpannaṃ	K10Dx_H0344:466a-7	གཞན་ཐམས་ཅད་ནི་ཚེ་འཕོས་། བྱམས་པ་མཆོད་སྦྱིན་ནི་ཟངས་ཀྱི་རལ་ཆེན་ཁ་སྐྱ་འདར་གྱིས་བཅད་པ་ཞིག་ལ་། འཇུ་འཇུ་ནས་རྒྱ་མཚོ་མཐར་ཕྱིན་ཏེ་འཕྱན་ཅིང་སོང་སོང་ན་། གྲོང་ཁྱེར་གསེར་གྱི་ར་བ་ཅན་བཟའ་ཤིང་གི་ར་བ་དང་ལྡན་པ་། རྫིང་བུ་དང་ལྡན་པ་།
K10mkarmviu:408	 puṣkariṇīsaṃpannam. dhūpitadhūpanaṃ muktapuṣpāvakīrṇam avasaktapaṭṭadāmakalāpam.	K10Dx_H0344:466a-12	བདུག་སྤོས་ཀྱིས་གདུགས་པ༏་མེ་ཏོག་སིལ་མས་གཏོར་བ་། དར་གྱི་ལྔ་ལྡི་མང་པོ་བྲེས་པ་ཞིག་མཐོང་ནས་།
K10mkarmviu:409	 tataś catasro 'psaraso nirgatāḥ. sa tābhir gṛhya nagaraṃ praveśitaḥ. sa tābhiḥ sārdhaṃ	K10Dx_H0344:466a-14	དེའི་ནང་ན་ལྷ་མོ་བཞི་ཞིག་འཐོན་ཏེ་། དེ་དག་གིས་ལག་ནས་བཟུང་སྟེ་ནང་དུ་ཁྲིད་དོ་༎
K10mkarmviu:410	 bahūni varṣāṇi krīḍitavān. bahūni varṣaśatāni. bahūni varṣasahasrāṇi bahūni varṣaśatasahasrāṇi	K10Dx_H0344:466a-16	དེ་ནས་དེ་དག་དང་ལོ་མང་པོ་། ལོ་བརྒྱ་ཕྲག་མང་པོ་། ལོ་སྟོང་ཕྲག་མང་པོ་། ལོ་བརྒྱ་སྟོང་ཕྲག་མང་པོར་རྩེ་རྩེ་ནས་ལྷ་མོ་དེ་དག་གིས་བསྒོ་བ་།
K10mkarmviu:411	 krīḍitavān. sa tābhir uktaḥ. āryaputra tavāyaṃ pṛthivīpradeśo 'pūrvaḥ. asmākam aviditaṃ	K10Dx_H0344:466b-0	འཕགས་༄༤༦༦བ་པའི་བུ་འདི་ནི་སྔན་ཆད་ཁྱོད་ལ་མེད་པའི་ཡུལ་ཡིན་གྱི་འདི་ནས་ཕྱི་རོལ་དུ་བྱུང་ཏ་རེ་།
K10mkarmviu:412	 na nirgantavyam. yadi nirgacchasi sarvathottarābhimukhena na gantavyam. iti. sa tasmāt	K10Dx_H0344:466b-1	བརྒྱ་ལ་འབྱུང་ནའང་ཁ་བྱང་ཕྱོགས་སུ་བལྟས་ཏེ་བྱུང་ཞིག་ཅེས་སྨྲས་སོ་༎
K10mkarmviu:413	 kālāntareṇa nirgataḥ. sa bhūyo gacchan nagaraṃ paśyati. rūpyamayena prākāreṇa. ārāmasaṃpannaṃ	K10Dx_H0344:466b-2	དེ་དུས་གཞན་ཞིག་ན་དེ་ནས་ཕྱི་རོལ་ཏུ་བྱུང་སྟེ་ཡང་འཕྱན་ཅིང་སོང་སོང་བ་དང་། གྲོང་ཁྱེར་དངུལ་གྱི་ར་བ་ཅན་། རྫིང་བུ་དང་ལྡན་པ་། བདུག་སྤོས་ཀྱིས་བདུགས་པ་།
K10mkarmviu:414	 vanasaṃpannam. pūrvavad yāvat. tasmād apy aṣṭāv apsaraso nirgatāḥ. tābhir apy asau  gṛhya praveśitaḥ. sa tābhiḥ sārdhaṃ bahūni varṣāṇi krīḍitavān. bahūni varṣaśatāni.  bahūni varṣasahasrāṇi bahūni varṣaśatasahasrāṇi krīḍitavān. pūrvavat. tato 'pi kālāntareṇa	K10Dx_H0344:466b-6	མེ་ཏོག་སིལ་མས་གཏོར་བ་། དར་གྱི་ལྡ་ལྡི་མང་པོ་བྲེས་པ་ཞིག་མཐོང་ངོ་༎ དེའི་ནང་ནས་ལྷ་མོ་བརྒྱད་འཐོན་ཏེ་།
K10mkarmviu:417	 nirgataḥ. bhūyaś ca paryaṭan nagaraṃ paśyati. vaidūryamayena prākāreṇa ārāmasaṃpannaṃ  vanasaṃpannam. puṣkariṇīsaṃpannam. dhūpitadhūpanam. muktapuṣpāvakīrṇam avasaktapaṭṭadāmakalāpam.	K10Dx_H0344:466b-9	སྔ་མ་བཞིན་དུ་རྩེ་རྩེ་ནས་དེ་ནས་ཀྱང་དུས་གཞན་ཞིག་ན་ཕྱིར་བྱུང་སྟེ་འཁྱམ་འཁྱམ་པ་ལས་གྲོང་ཁྱེར་བེཨེ་དའུརྱའི་ར་བ་ཅན་ནས་།
K10mkarmviu:419	 tasmād api ṣoḍaśāpsaraso nirgatāḥ. tābhir api sārdhaṃ bahūni varṣāṇi krīḍitavān.	K10Dx_H0344:466b-10	དར་གྱི་ལྡ་ལྡི་མང་པོ་བྲེས་པ་སྔ་མ་བཞིན་དུ་མཐོང་ནས་། དེའི་ནང་ནས་ལྷ་མོ་བཅུ་དྲུག་འཐོན་ཏེ་།
K10mkarmviu:422	 tasmāt kālāntareṇa nirgataḥ. bhūyāḥ paryaṭamānaḥ (MKV 53)  sphaṭikaprākāreṇa nagaram. tathaivārāmasaṃpannam. vanasaṃpannaṃ puṣkariṇīsaṃpannam.	K10Dx_H0344:466b-13	དེ་དག་དང་ཡང་ལོ་བརྒྱ་སྟོང་མང་པོར་རྩེ་རྩེ་ནས་། དེ་ནས་ཀྱང་དུས་གཞན་ཞིག་ནས་ཕྱིར་བྱུང་སྟེ་འཁྱམ་འཁྱམ་པ་ལས་། གྲོང་ཁྱེར་ཤེལ་གྱི་ར་བ་ཅན་ནས་དར་གྱི་ལྡ་ལྡི་མང་པོ་བྲེས་པའི་བར་དུ་སྔ་མ་བཞིན་དུ་མཐོང་ནས་།
K10mkarmviu:424	 dhūpitadhūpanaṃ muktapuṣpāvakīrṇam avasaktapaṭṭadāmakalāpam. tasmād api dvātriṃśad	K10Dx_H0344:466b-16	དེའི་ནང་ནས་ལྷ་མོ་སུམ་ཅུ་རྩ་གཉིས་འཐོན་ཏེ་། དེ་དག་གིས་ཀྱང་ལག་ནས་བཟུང་སྟེ་ནང་དུ་ཁྲིད་དོ་༎
K10mkarmviu:426	 krīḍitavān. sa tābhir apy uktaḥ. āryaputra tavāyaṃ pṛthivīpradeśo 'pūrvaḥ. asmād  vihārāt tena na nirgantavyam. atha nirgacchasi. uttarāmukhena na gantavyam iti. sa	K10Dx_H0344:467a-0	འཕགས་པའི་བུ་འདི་ནི་ཁྱེད་ལ་མེད་༄༤༦༧ཨ་༌༎ པའི་ས་ཕྱོགས་ཡིན་གྱི་། གནས་འདི་ནས་ཕྱི་རོལ་དུ་བྱུང་ཏ་རེ་། བརྒྱ་ལ་འབྱུང་ནའང་ཁ་བྱང་ཕྱོགས་སུ་ལྟོས་ཏེ་བྱུང་ཞིག་ཅེས་སྨྲས་པའི་འོག་ཏུ་དེ་ཁང་པ་དེ་ནས་བྱུང་སྟེ་ཁ་བྱང་ཕྱོགས་སུ་བལྟས་ནས་སོང་སོང་བ་ལས་།
K10mkarmviu:428	 tāsāṃ pramādād ratikhinno nirgataḥ. uttarābhimukhena gacchan kaṇṭakāṭavīṃ prapannaḥ.  atha kṛṣṇāyasena prākāreṇa nagaraṃ paśyati. sa tatra praviṣṭaḥ. praviṣṭamātrasya	K10Dx_H0344:467a-4	ཚེར་མའི་ནགས་ཚལ་ཞིག་ཏུ་ཕྱིན་པ་དང་། གྲོང་ཁྱེར་ལྕགས་ཀྱི་ར་བ་ནག་པོ་ཅན་ཞིག་མཐོང་སྟེ་། དེར་དེར་སོང་སོང་བ་དང་ནང་དུ་ཕྱིན་མ་ཐག་ཏུ་གྲོང་ཁྱེར་གྱི་སྒོ་འགགས་ནས་།
K10mkarmviu:430	 ca nagaradvāraṃ pihitam. ūrdhvaṃ paśyati. prākāro vardhate bhairavaṃ ca śabdaṃ śṛṇoti.	K10Dx_H0344:467a-6	ར་བའི་གོང་དུ་བལྟས་ན་ཡང་མཐོ་བར་གྱུར་ཏེ་མཐར་སྒྲ་འཇིགས་པ་ཞིག་ཀྱང་ཐོས་ནས་།
K10mkarmviu:431	 tatrasthaś ca cintayati. kim etad iti. sa tatra gataḥ. atha paśyati puruṣasyāsidharaṃ  cakraṃ śiraś chinatti. sa bhītaḥ pṛcchati. kim etad bho puruṣa. nairayikapuruṣaḥ	K10Dx_H0344:467a-7	དེ་ན་གནས་བཞིན་དུ་འདི་ཅི་ཞིག་སྙམ་དུ་བསམས་པ་དང་། རལ་གྲི་འཁོར་ལོ་མགོ་ལ་འཁོར་ཞིང་གཅོད་པའི་མི་ཞིག་མཐོང་ནས་དངངས་ཏེ་། ཀྱེ་མ་། འདི་ཅི་ཞིག་ཅེས་དྲིས་པ་དང་། སེམས་ཅན་དམྱལ་བ་པའི་མི་དེས་འདི་ནི་ཉི་ཚེ་བའི་སེམས་ཅན་དམྱལ་བའོ་ཞེས་སྨྲ་བ་དང་། བྱམས་པ་མཆོད་སྦྱིན་གྱིས་།
K10mkarmviu:433	 prāha. eṣa pratyekanarakaḥ. maitrāyajña āha. kiṃ tvayā pāpakarma kṛtam iti. sa kathayati.	K10Dx_H0344:467a-9	ཁྱོད་ཀྱིས་སྡིག་པའི་ལས་ཅི་ཞིག་བྱས་ཞེས་སྨྲས་སོ་༎ དེས་སྨྲས་པ་།
K10mkarmviu:434	 asmin jambudvīpe mahākośalī nāma nagaram. tatrāhaṃ mahāsārthavāhaputro 'bhūvam. sa	K10Dx_H0344:467a-11	འཛམ་བུའི་གླིང་ན་གྲོང་ཁྱེར་ཀོ་ས་ལི་ཞེས་བྱ་བ་ཞིག་ཡོད་དེ་། བདག་ཀྱང་དེ་ན་དེད་དཔོན་གྱི་བུ་ཞིག་ཏུ་གྱུར་ཅིང་འདུག་འདུག་པ་ལས་།
K10mkarmviu:435	 pañcabhiḥ sahāyaśataiḥ sahodyānaṃ gataḥ. te kathayanti. tava pitā sārthavāho 'smākaṃ  pūrvapuruṣo 'sti. pūrvaṅgamaṃ kṛtvā deśāntarāṇi gatvā dravyopārjanāni kurvanti. suvarṇabhūmiṃ	K10Dx_H0344:467a-13	བདག་གྲོགས་ལྔ་བརྒྱས་བསྐོར་ཏེ་བཟའ་ཤིང་གི་ར་བ་ཆེན་པོར་ཕྱིན་པ་དང་། གྲོགས་པོ་དེ་དག་གིས་སྨྲས་པ་། ཁྱོད་ཀྱི་ཕ་ནི་དེད་དཔོན་ཡིན་༄༤༦༧བ་ཏེ༏་དེ་དག་ལ་སོགས་པ་བདག་ཅག་གི་ཕ་རྣམས་ཡུལ་གཞན་དུ་དོང་ཞིང་ནོར་ལ་གསོག་པ་ཡང་བྱེད་།
K10mkarmviu:437	 siṃhaladvīpaṃ ca prabhṛtīni ca dvīpāntarāṇi paśyanti. vayam	K10Dx_H0344:467b-1	གསེར་གནས་དང་། སིང་གྷ་ལའི་གླིང་ལ་སོགས་པ་གླིང་གཞན་དག་ཀྱང་ལྟ་ན་།
K10mkarmviu:438	 api tvayā pūrvaṅgamena deśāntaraṃ paśyāma iti. vayam api gacchāma iti pratiśrutam.  so 'haṃ gṛhaṃ gatvā mātaram āpṛṣṭavān. aham evaṃ deśāntaraṃ gamiṣyāmīti. mātā ma	K10Dx_H0344:467b-2	བདག་ཅག་ཀྱང་ཁྱོད་ཀྱིས་གཙོ་བོ་བྱས་ཏེ་ཡུལ་གཞན་དུ་འདོང་ངོ་ཞེས་སྨྲས་པ་དང་། དེ་དག་གིས་མཉན་ཏེ་ཁྱིམ་དུ་ཕྱིན་ནས་མ་ལ་བདག་གྲུར་ཞུགས་ཏེ་ཡུལ་གཞན་དུ་འགྲོའོ་ཞེས་དྲིས་པ་དང་། བདག་གི་མས་སྨྲས་པ་།
K10mkarmviu:440	 āha. putra tava pitā samudram avatīrṇo deśāntaraṃ gata eva kālagataḥ. tvam ekaputrakaḥ.	K10Dx_H0344:467b-3	བུ་ཁྱོད་ཀྱི་ཕ་ཡང་རྒྱ་མཚོ་ལས་གྲུར་ཞུགས་ཏེ་ཡུལ་གཞན་དུ་སོང་སོང་བ་ལས་ཚེ་འཕོས་ཏེ་། བུ་ཡང་ཁྱོད་གཅིག་པུར་ཟད་ལ་།
K10mkarmviu:441	 prabhūtaṃ gṛhe dravyaṃ tiṣṭhati. na gantavyam. iti. mayā na gacchāmīti pratiśrutam.	K10Dx_H0344:467b-6	བདག་གིས་ཀྱང་མི་འགྲོའོ་ཞེས་མའི་དག་མཉན་ཏེ་།
K10mkarmviu:442	 evaṃ dvitīyaṃ tṛtīyaṃ caturtham apy āpādapatanaṃ nivartitaḥ. kālāntareṇāhaṃ bhūyo  'py udyānaṃ gataḥ sahāyair uktaḥ. avaśyaṃ gantavyam iti. gamiṣyāmīti mayā pratiśrutam.  atha mama prasthitasya mātā dvāre pādapatanaṃ kṛtvā sthitā. putra nārhasi māṃ parityaktum  iti. tasyāhaṃ mastake pādaṃ dattvā prakrāntaḥ. so 'haṃ pañcabhiḥ sahāyaśataiḥ sārdhaṃ	K10Dx_H0344:467b-10	ཞེས་སྨྲས་ནས་།
K10mkarmviu:452	 krīḍitam. tataḥ kālāntareṇa nirgacchan pa ... pūrvavat. tasmād apsaraso nirgatāḥ.  tābhiḥ praveśito 'smi. yāvat. tābhir api sārdhaṃ bahūni varṣāṇi bahūni varṣaśatāni  bahūni varṣaśatasahasrāṇi krīḍitam. evaṃ vaidūryamayam. tasmād api ṣoḍaśāpsaraso	K10Dx_H0344:468a-5	བཟའ་ཤིང་གི་ར་བ་དང་ལྡན་པ་། རྫིང་བུ་དང་ལྡན་པ་། བདུག་སྤོས་ཀྱིས་བདུགས་པ་། མེ་ཏོག་སིལ་མས་གཏོར་བ་། དེའི་ནང་ནས་ལྷ་མོ་བཞི་ཞིག་འཐོན་པ་ནས་།
K10mkarmviu:455	 nirgatāḥ .... tasmād api nirgatah. sphaṭikamayaṃ nagaraṃ paśyāmi. pūrvavat. tasmād  dvātriṃśad apsaraso nirgatāḥ. tābhir api saha tathaiva krīḍitam ...... kaṇṭakāṭavīṃ	K10Dx_H0344:468a-11	ལྷ་མོ་སུམ་ཅུ་རྩ་གཉིས་འཐོན་པ་དང་། གྲོང་ཁྱེར་ལྕགས་ཀྱི་ར་བས་བསྐོར་བ་ཞིག་མཐོང་བའི་བར་དུ་སྔ་མ་བཞིན་ཏེ་། བདག་དེའི་ནང་དུ་ཕྱིན་པ་དང་། དེ་མ་ཐག་ཏུ་སྒོའང་འགགས་།
K10mkarmviu:458	 pihitam. atra ca pūrvavat ....... asidharaṃ cakraṃ śirasi parivartamānaṃ paśyāmi.  tatra ca mamāvasthitasya śirasi asidharaṃ cakraṃ saṃkrāntam. yad ahaṃ mātu ... nivṛttaḥ.	K10Dx_H0344:468a-13	དེ་ན་མི་ཞིག་ཀྱང་རལ་གྲི་འཁོར་ལོ་མགོ་ལ་འཁོར་ཞིང་འདུག་པ་མཐོང་ནས༏་བདག་འདི་ན་འདུག་འདུག་པའི་མགོ་ལ་འཁོར་ལོ་འཕོས་པར་གྱུར་ཏོ་༎
K10mkarmviu:460	 aṣṭāṅgasamanvāgataṃ ca poṣadhaṃ gṛhītam. tasya karmaṇo vipākena caturṣu mahānagareṣu	K10Dx_H0344:468a-14	བདག་མའི་ཚིག་གིས་ལན་བཞི་ཕྱིར་ལོག་པ་དང་། ཁྲིམས་བརྒྱད་མནོས་པའི་ལས་ཀྱི་རྣམ་པར་སྨིན་པས་གྲོང་ཁྱེར་བཞིར་ཉི་ཚེ་བའི་མཐོ་རིས་ཉམས་སུ་མྱོང་བར་གྱུར་ཏོ་༎
K10mkarmviu:461	 pratyekasvargasva .... mātuḥ śirasi pādaṃ dattvā gataḥ. tasya karmaṇo vipākena mamāsidharaṃ  cakraṃ śiraś chinatti. maitrāyajñaś cintayati. mayāpy etad eva karma kṛtam. upasthito	K10Dx_H0344:468a-15	བདག་གིས་མའི་མགོ་ལ་འགོམས་ཏེ་སོང་བའི་ལས་ཀྱི་རྣམ་པར་སྨིན་པས་ནི་། རལ་གྲི་འཁོར་ལོ་མགོ་ལ་འཁོར་ཞིང་གཅོད་པ་འདི་ཡིན་ནོ་ཞེས་བྱས་པ་དང་། བྱམས་པ་མཆོད་སྦྱིན་གྱིས་བསམས་པ་། བདག་གིས་ཀྱང་སྔོན་ལས་དེ་ཁོ་ན་དང་འདྲ་བར་བྱས་༄༤༦༨བ་ཀྱི༏་བདག་གི་ལས་རྣམ་པར་སྨིན་པའང་ཉེ་བར་གནས་པར་གྱུར་པ་ལྟའོ་སྙམ་པ་དང་། སེམས་ཅན་དམྱལ་བའི་མི་དེས་། བྱམས་པ་མཆོད་སྦྱིན་།
K10mkarmviu:463	 mamāpi karmavipāka iti. nairayikapurusaḥ prāha. kutas tvam. maitrāyajñaḥ kathayati.	K10Dx_H0344:468b-2	ཁྱོད་གང་ནས་འོངས་ཞེས་སྨྲས་པ་དང་། བྱམས་པ་མཆོད་སྦྱིན་གྱིས་སྨྲས་པ་།
K10mkarmviu:464	 asti jambudvīpe tāmaliptaṃ nāma mahānagaram. tato 'ham. mayāpi caitat sarvam anuṣṭheyam.	K10Dx_H0344:468b-3	འཛམ་བུའི་གླིང་ན་གྲོང་ཁྱེར་ཏ་མ་ལི་པ་ཏི་ཞེས་བྱ་བ་ཞིག་ཡོད་དེ་། བདག་ནི་དེ་ནས་འོངས་ཏེ་། བདག་གིས་ཀྱང་ལས་དེ་དག་ཐམས་ཅད་བྱས་སོ་༎
K10mkarmviu:465	 nairayikapuruṣaḥ prāha. asti mayādyāntarikṣe ghoṣaḥ śrutaḥ. kṣīṇas tava karmavipākaḥ.	K10Dx_H0344:468b-6	སེམས་ཅན་དམྱལ་བ་པའི་མི་དེས་སྨྲས་པ་། དེ་བདེན་པ་ལྟ་སྟེ་། བདག་གིས་ཀྱང་བར་སྣང་ལས་སྒྲ་ཐོས་ནས་། ཁྱོད་ཀྱི་ལས་ཀྱི་རྣམ་པར་སྨིན་པ་ཟད་དེ་།
K10mkarmviu:466	 maitrāyajño nāma sārthavāhaputraḥ adyāgamiṣyati. etad eva karma kṛtveti. maitrāyajña	K10Dx_H0344:468b-10	དེད་དཔོན་གྱི་བུ་ཐམས་པ་མཆོད་སྦྱིན་ཞེས་བྱ་བ་ལས་དེ་དང་འདྲ་བར་བྱས་པ་ཞིག་འོང་ངོ་ཞེས་ཐོས་སོ་༎
K10mkarmviu:467	 āha. kiṃ bhojanam. sa āha. ata eva mastakāc chidyamānād yat pūyaśoṇitaṃ sravati.	K10Dx_H0344:468b-11	བྱམས་པ་མཆོད་སྦྱིན་གྱིས་ཟས་སུ་ཅི་ཟ་ཞེས་སྨྲས་པ་དང་། དེས་མགོ་འདི་ཉིད་ཀྱི་བ་ལས་། ཤ་དང་རྣག་ཁྲག་འོང་བ་ཟའོ་ཞེས་སྨྲས་ནས་།
K10mkarmviu:468	 evam uktvā sa puruṣaḥ kālagataḥ patitaḥ. maitrāyajño bhītaḥ saṃvignaḥ. sarveṇa bhāvena  mātāpitroḥ praṇipātaṃ kṛtvāha.	K10Dx_H0344:468b-13	མི་དེ་ཡང་དེར་ཚེ་འཕོས་པར་གྱུར་ཏོ་༎ བྱམས་པ་མཆོད་སྦྱིན་འཇིགས་ཤིང་མི་དགའ་བས་། མའི་དོན་དུ་སྨོན་ལམ་བཏབ་སྟེ་། འདི་སྐད་ཅེས་སྨྲས་སོ་༎ འཇིག་རྟེན་བགྲང་དུ་མེད་པ་ཐམས་ཅད་ཀྱི་༎
K10mkarmviu:470	 ūrdhvaṃ bhavāgravitatān adharād avīciṃ	K10Dx_H0344:468b-18	སྲིད་རྩེ་མན་ཆད་མནར་མེད་ཡན་ཆད་ན་༎
K10mkarmviu:471	 tiryakprathān agaṇitān api lokadhātūn  ātmansva surāsuranaroragabhūtakāye  satvāni yāni upagatāni sukhino bhavantu  (MKV 55)	K10Dx_H0344:468b-19	ལྷ་དང་ལྷ་མིན་ལྟོ་འཕྱེ་ཆེན་པོའི་ཚོགས་༎ བདེ་བར་གྱུར་ཅིག་སྡུག་བསྔལ་བདག་གིས་བླང་༎ དེ་སྐད་ཅེས་སྨྲས་ནས་།
K10mkarmviu:476	 ca kṛtavān. yatra yatropapadyāmi mātāpitroḥ śuśrūṣāṃ kuryām aham iti. ye ca kecana	K10Dx_H0344:468b-22	བསམ་པ་ཐག་པས་ཕ་མ་ལ་ཕྱག་འཚལ་ཏེ་སྨོན་ལམ་བཏབ་བོ་༎ གར་སྐྱེས་གར་སྐྱེས་༄༤༦༩ཨ་༌༎ ཀྱང་ཕ་མའི་རིམ་གྲོ་བྱའོ་༎
K10mkarmviu:477	 satvā pratyekanarake upapadyante teṣāṃ sarveṣām arthāyāham atrāvasthitaḥ. ye ca kecana	K10Dx_H0344:469a-2	ཉི་ཚེ་བའི་སེམས་ཅན་དམྱལ་བ་འདིར་སྐྱེ་བར་འགྱུར་བ་དེ་དག་གི་དོན་དུ་བདག་འདི་ན་གནས་སོ་༎
K10mkarmviu:478	 loke yuktāś ca muktāś ca teṣāṃ namaḥ. te māṃ pālayantu. idam uktvā tasmin nairayikapuruṣaḥ	K10Dx_H0344:469a-3	འཇིག་རྟེན་ན་རིགས་པ་དང་ལྡན་པ་དང་། གྲོལ་བར་གྱུར་པ་སུ་བཞུགས་པ་དེ་དག་ལ་ཕྱག་འཚལ་ལོ་༎ དེ་དག་གིས་ཀྱང་བདག་བསྐྱབ་ཏུ་གསོལ་ཞེས་སྨྲས་ནས་།
K10mkarmviu:479	 kāle sthitaḥ. punaś ca praṇidhānaṃ kṛtvā punar apy āha.	K10Dx_H0344:469a-6	ཡང་ཕ་མའི་དོན་དུ་སྨོན་ལམ་བཏབ་པ་།
K10mkarmviu:480	 kṛtvādau narakam avīcim ābhavāgrād  ye satvāś cyutigatibandhanāvabaddhāḥ	K10Dx_H0344:469a-7	སེམས་ཅན་དམྱལ་བ་མནར་མེད་མཐའ་ནས་སྲིད་རྩེ་མན་ཆད་ནས་༎ སེམས་ཅན་ཚེ་འཕོའི་རྣམ་པ་འཆིང་བས་ཇི་སྙེད་བཅིངས་པ་དག་།
K10mkarmviu:482	 te sarve sukham atināpya dharmayuktaṃ	K10Dx_H0344:469a-9	ཐམས་ཅད་མ་ལུས་ཆོས་དང་ལྡན་ཞིང་བདེ་བར་འཚོ་འགྱུར་ཏེ་༎
K10mkarmviu:483	 nirvāṇaṃ yad ajaram acyutaṃ spṛśantu.	K10Dx_H0344:469a-10	རྒན་མེད་ཚེ་འཕོ་མེད་པའི་མྱ་ངན་འདས་པ་ཐོབ་གྱུར་ཅིག་།
K10mkarmviu:484	 atha tac cakram aspṛśamānaṃ śirasi nityakālam evopari vihāyasi sthitam. nityaṃ ca	K10Dx_H0344:469a-11	དེ་སྐད་ཅེས་བརྗོད་དེ་བསྡད་པ་དང་། འཁོར་ལོ་དེ་མགོ་ལ་མ་རེག་པར་སྟེང་གི་ནམ་མཁའ་ལ་འཁོར་བར་གྱུར་ཏོ་༎
K10mkarmviu:485	 kila tasya mātāśiṣaṃ prayuṅkte. yady asti mama kiṃcit puṇyaphalaṃ pradānena vā śīlena	K10Dx_H0344:469a-12	དེའི་མས་ཀྱང་གལ་ཏེ་བདག་གི་སྦྱིན་པའམ་།
K10mkarmviu:486	 vā brahmacaryeṇa vā pativratatvena vā tena puṇyaphalena mama putrasya yatra tatra  sthitasya mā kiṃcit pāpaṃ bhavatu. tena ca tasya śivam āsīt.	K10Dx_H0344:469a-13	ཚུལ་ཁྲིམས་སམ་། བདག་གིས་ཁྱིམ་ཐབ་ཀྱི་བརྟུལ་ཞུགས་བྱས་པའི་བསོད་ནམས་ཀྱི་འབྲས་བུ་ཞིག་ཡོད་ན་།
K10mkarmviu:494	 pañcasu sthāneṣu pratyupasthitau pañcasu sthāneṣu pratiṣṭhāpayataḥ. tasya punar gṛhapatiputra  mātāpitṛbhyām anukampitasya puruṣapudgalasya vṛddhir evaṃ pratyāśaṃsitavyā.	K10Dx_H0344:469a-16	བདག་གི་བུ་གང་དང་གང་ན་གནས་ཀྱང་བདེ་བར་གྱུར་ཅིག་ཅེས་རྟག་པར་སྨོན་ལམ་བཏབ་པས་དེ་ལྟར་ཞི་བར་གྱུར་ཏོ་༎
K10mkarmviu:496	 c) sa tatra prītyāhāraḥ sthitvā paripūrṇeṣu ṣaṣṭivarṣasahasreṣu kālagataḥ.	K10Dx_H0344:469a-17	དེ་ཡང་ཉི་ཚེ་བའི་སེམས་ཅན་དམྱལ་བ་དེ་ན་འདུག་འདུག་ནས་། ལོ་དྲུག་ཅུའང་མ་ལོན་པར་ཚེ་༄༤༦༩བ་འཕོས་པར་གྱུར་ཏེ་།
K10mkarmviu:497	 d) yathā rājājātaśatrur aparipūrṇa eva nairayikāyuḥpramāṇe cyutaḥ. abandhyatvāt karmaṇāṃ kadācid atīva śirorujā bhavati.  e) atra kṛtapraṇidhānasya maitrāyajñasya mātāpitṛśuśrūṣā vaktavyā. yathā śyāmajātake 'ndhau mātāpitarau hastibhūtena paripālitau. anyeṣu jātakaśateṣu	K10Dx_H0344:469b-1	དཔེར་ན་། རྒྱལ་པོ་མ་སྐྱེས་དགྲ་སེམས་ཅན་དམྱལ་བའི་ཚེ་ཡོངས་སུ་མ་རྫོགས་པར་ཚེ་འཕོས་པ་ལྟ་བུ་སྟེ་། ལས་ཀྱི་འབྲས་བུ་ཆུད་ཟ་བ་མེད་པའི་ཕྱིར་རབ་བར་ཀླད་པ་ན་བར་གྱུར་ཏོ་༎
K10mkarmviu:499	 f) atha bhagavān prāptakālaṃ bhikṣūn āmantrayate. syād evaṃ bhikṣavo yuṣmākam anyaḥ	K10Dx_H0344:469b-3	དེ་ནས་སྐབས་སུ་བབ་ནས་བཅོམ་ལྡན་འདས་ཀྱིས་དགེ་སློང་རྣམས་ལ་བཀའ་སྩལ་པ་།
K10mkarmviu:500	 sa tena kālena tena samayena maitrāyajño nāma sārthavāhaputro babhūveti. naivaṃ draṣṭavyam.	K10Dx_H0344:469b-4	དགེ་སློང་དག་། དེའི་ཚེ་དེའི་དུས་ན་དད་དཔོན་གྱི་བུ་བྱམས་པ་མཆོད་སྦྱིན་ཞེས་བྱ་བ་དེ་གཞན་ཞིག་ཡིན་པར་སེམས་ན་དེ་ནི་དེ་ལྟར་མི་ལྟ་སྟེ་།
K10mkarmviu:501	 ahaṃ sa tena kālena tena samayena maitrāyajño nāma sārthavāhaputra āsīt. tasmāt tarhi	K10Dx_H0344:469b-6	ང་ཉིད་དེའི་ཚེ་དེའི་དུས་ན་དེད་དཔོན་གྱི་བུ་བྱམས་པ་མཆོད་སྦྱིན་ཞེས་བྱ་བར་གྱུར་ཏོ་༎
K10mkarmviu:502	 bhikṣavo mama vacanaṃ śraddadhānair buddhe sagauravair bhavitavyaṃ dharme saṃghe	K10Dx_H0344:469b-7	དགེ་སློང་དག་། དེ་ལྟ་བས་ན་ངའི་ཚིག་ལ་ཡིད་ཆེས་པར་བྱས་ཏེ་སངས་རྒྱས་བཅོམ་ལྡན་འདས་ལ་རིམ་གྲོ་ཡོད་པར་བྱའོ་༎
K10mkarmviu:503	 sagauravair bhavitavyam. mātāpitṛṣu ācāryopādhyāyeṣu sagauravair bhavitavyam. evaṃ	K10Dx_H0344:469b-9	ཆོས་དང་དགེ་འདུན་ལ་རིམ་གྲོ་ཡོད་པར་བྱའོ་༎ ཕ་མ་དང་། མཁན་པོ་དང་། སློབ་དཔོན་ལ་རིམ་གྲོ་ཡོད་པར་བྱའོ་༎
K10mkarmviu:504	 vo bhikṣavaḥ śikṣitavyam. ya evaṃ deśāntaragataḥ sukhaṃ duḥkhaṃ pratyanubhavati. (MKV 57)	K10Dx_H0344:469b-11	དགེ་སློང་དག་། ཁྱེད་ཀྱིས་འདི་ལྟར་ཤེས་པར་བྱ་སྟེ་། གང་ཡུལ་གཞན་དུ་སོང་ཞིང་བདེ་བ་དང་། སྡུག་བསྔལ་ཉམས་སུ་མྱོང་བ་ཡོད་དེ་།
K10mkarmviu:505	 yathā maitrāyajñena deśāntaragatena tasminn eva janmani pratyekasvargaṃ pratyekanarakaṃ	K10Dx_H0344:469b-14	དཔེར་ན་། བྱམས་པ་མཆོད་སྦྱིན་ཡུལ་གཞན་དུ་སོང་ནས་ཚེ་དེ་ཉིད་ལ་ཉི་ཚེ་བའི་མཐོ་རིས་དང་། ཉི་ཚེ་བའི་སེམས་ཅན་དམྱལ་བ་མྱོང་བར་གྱུར་པ་ལྟ་བུ་སྟེ་།
K10mkarmviu:506	 cānubhūtam. ya evaṃ deśāntaragataḥ sukhaṃ duḥkhaṃ pratyanubhavati. idaṃ karma deśāntaravipākam.	K10Dx_H0344:469b-15	དེ་ལྟར་ཡུལ་གཞན་དུ་བདེ་བ་དང་སྡུག་བསྔལ་ཉམས་སུ་མྱོང་བར་གྱུར་པའི་ལས་དེ་ལྟ་བུ་ནི་ཡུལ་གཞན་དུ་རྣམ་པར་སྨིན་པར་འགྱུར་བའོ་༎
K10mkarmviu:507	 g) etad darśayati bhagavān. yathā mayi tathā mātāpitṛṣu. ācāryopādhyāyeṣu vacanakāriṇāṃ	K10Dx_H0344:470a-1	ལྡན་འདས་ཀྱིས་དེ་སྐད་ཅེས་གསུངས་ཏེ་། ང་ལ་ཅི་བྱས་པ་དང་། ཕ་མ་དང་། མཁན་པོ་དང་། སློབ་དཔོན་ལ་ཅི་བྱས་པ་དེ་དག་ནི་བྱེ་བྲག་མེད་ཅིང་མཚུངས་ཏེ་།
K10mkarmviu:508	 samo vipākaḥ iha loke paraloke ca. katham iha loke samaḥ karmavipāko bhavati. yathā	K10Dx_H0344:470a-3	ཚེ་འདི་དང་། ཕྱི་མ་ལའང་རྣམ་པར་སྨིན་པ་མི་མཉམ་པ་མེད་དོ་༎ ཇི་ལྟར་ན་ཚེ་འདི་ལ་རྣམ་པར་སྨིན་པ་མཚུངས་ཤིང་མཉམ་པ་ཡིན་ཞེ་ན་།
K10mkarmviu:509	 śrāvastyāṃ daridrapuruṣo bhagavantaṃ saśrāvakasaṃghaṃ bhuñjānaṃ dṛṣṭvā cittaṃ prasāditavān.  tena mahāpuṇyasaṃbhāra upārjitaḥ rājyasaṃvartanīyaṃ karma kṛtam. tad eva ca mokṣabījam.	K10Dx_H0344:470a-5	དཔེར་ན་། མཉན་དུ་ཡོད་པ་ན་བཅོམ་ལྡན་འདས་དང་ཉན་ཐོས་ཀྱི་དགེ་འདུན་བཤོས་གསོལ་བ་མི་ཕོངས་པ་གཅིག་ཅིག་གིས་མཐོང་ནས་སེམས་མོས་པར་བྱས་པས་དེས་བསོད་ནམས་ཀྱི་ཚོགས་ཆེན་པོ་ཡང་བསགས་པར་གྱུར་། རྒྱལ་པོར་འགྱུར་བའི་ལས་ཀྱང་བྱས་།
K10mkarmviu:511	 tac ca jñātvā bhagavatā gāthā bhāṣitā.	K10Dx_H0344:470a-7	དེ་ཉིད་ཐར་པའི་ས་བོན་དུ་གྱུར་པ་དེ་ཐུགས་སུ་ཆུད་ནས་། བཅོམ་ལྡན་འདས་ཀྱིས་ཚིགས་སུ་བཅད་དེ་གསུངས་པ་།
K10mkarmviu:512	 ye tatrābhyanumodante vaiyāvṛtyakarāś ca ye	K10Dx_H0344:470a-9	དེ་ལ་རྗེས་སུ་ཡི་རང་སུ་བྱེད་གང་༎
K10mkarmviu:515	 manaḥpūrvaṅgamā dharmā manaḥśreṣṭhā manojavāḥ	K10Dx_H0344:470a-11	ཞེས་བྱ་བ་ལ་སོགས་པ་གསུངས་པ་དང་། ཆོས་རྣམས་སྔོན་དུ་ཡིད་འགྲོ་སྟེ་༎ ཡིད་ཀྱིས་ཆོས་འགྱུར་ཡིད་ཀྱིས་འགྲོ་།
K10mkarmviu:516	 manasā cet prasannena bhāṣate vākaroti vā	K10Dx_H0344:470a-13	ཡིད་ནི་ལེགས་པར་མོས་འགྱུར་ན་༎ སྨྲ་བའམ་བྱེད་པ་ཀུན་ཏུ་འགྱུར་༎
K10mkarmviu:517	 tatas taṃ sukham anveti chāyā vā anuyāyinī.	K10Dx_H0344:470a-15	གྲིབ་མ་རྗེས་སུ་འབྲང་བ་བཞིན་༎ དེ་ལས་བདེ་བ་འཐོབ་པར་འགྱུར་༎
K10mkarmviu:518	 tataś cyutaś ca deveṣūpapannaḥ. yathā ca tagaraśikhī nāma pratyekabuddhaḥ. durbhikṣe	K10Dx_H0344:470a-17	ཞེས་གསུངས་པ་དང་། དེ་ནས་ཚེ་འཕོས་པའི་འོག་ཏུ་ལྷར་སྐྱེས་པ་ལྟ་བུ་དང་། དཔེར་ན་། གྲོང་ཁྱེར་གཙུག་ཕུད་ཅེས་བྱ་བའི་རང་སངས་༄༤༧༠བ་རྒྱས་ལྟ་བུ་སྟེ་།
K10mkarmviu:519	 daridrapuruṣeṇa sūpaḥ pratipāditaḥ. sa ca tadahar eva tasmin nagare rājābhiṣiktaḥ.	K10Dx_H0344:470b-1	དེ་ལ་ལོ་ཉེས་པ་ཞིག་གི་ཚེ་མི་དབུལ་པོ་ཞིག་གིས་བསོད་སྙོམས་ཤིག་ཕུལ་བས་།
K10mkarmviu:520	 tataḥ kālāntareṇa pratyekabuddhaḥ saṃvṛttaḥ. ya eṣa sūtrantare paripaṭhitaḥ pratyekabuddhas (MKV 58)	K10Dx_H0344:470b-2	དེ་དེ་ཉིད་ཀྱི་ཚེ་རྒྱལ་བོར་དབང་བསྐུར་ནས་དུས་གཞན་ཞིག་ན་རང་སངས་རྒྱས་སུ་གྱུར་པ་ལྟ་བུའོ་༎ དེ་ཡང་མདོ་སྡེ་དག་ལས་གསུངས་པ་༎
K10mkarmviu:521	 tagaraśikhī nāma. evaṃ tāvad bhagavati sāṃdṛṣṭikaś cittaprasādasya phalavipākaḥ.	K10Dx_H0344:470b-4	གྲོང་ཁྱེར་གཙུག་ཕུད་ཅེས་བྱ་བ་དེ་དང་འདྲ་བར་སེམས་མོས་པའི་འབྲས་བུ་ཚེ་འདི་ཉིད་ལ་རྣམ་པར་སྨིན་པར་འགྱུར་རོ་ཞེས་གསུངས་པ་དང་། ཕ་མ་ལ་རིམ་གྲོ་བྱས་ན་།
K10mkarmviu:522	 h) kathaṃ mātāpitṛṣu. yathā maitrāyajñaḥ sārthavāhaputraḥ ācaturthaṃ pratinivṛtto	K10Dx_H0344:470b-5	དེད་དཔོན་གྱི་བུ་བྱམས་པ་མཆོད་སྦྱིན་གྱིས་མའི་ངག་མཉན་ཏེ་ལན་བཞི་ཕྱིར་ལོག་པས་གྲོང་ཁྱེར་ཆེན་པོ་བཞིར་ཉི་ཚེ་བའི་མཐོ་རིས་མྱོང་བར་གྱུར་པ་དེ་དེའི་ཐར་པའི་ས་བོན་དུ་གྱུར་པ་ལྟར་།
K10mkarmviu:523	 mātur vacanena caturṣu mahānagareṣu pratyekasvargasukham anubhūtavān. tat tu tasya  mokṣabījam. evaṃ mātāpitṛṣv api sāṃdṛṣṭikaḥ phalavipākaḥ.	K10Dx_H0344:470b-6	ཚེ་འདི་ལ་འབྲས་བུ་རྣམ་པར་སྨིན་པར་འགྱུར་རོ་ཞེས་གསུངས་པ་ལྟ་བུའོ་༎
K10mkarmviu:525	 i) kathaṃ bhagavati mātāpitṛṣu ca cittapradoṣeṇa narakagamanaṃ bhavati. ucyate. devadatto	K10Dx_H0344:470b-7	ཇི་ལྟར་ན་བཅོམ་ལྡན་འདས་དང་། ཕ་མ་ལ་ཞེ་སྡང་བར་བྱས་པའི་སེམས་ཀྱིས་སེམས་ཅན་དམྱལ་བར་འགྲོ་བར་འགྱུར་ཞེ་ན་། དེ་ནི་དཔེར་ན་།
K10mkarmviu:526	 bhagavati cittaṃ pra ... to 'vīcau mahānarake patitaḥ. tathā sindhu viṣaye raurukaṃ	K10Dx_H0344:470b-9	ལྷས་བྱིན་གྱིས་བཅོམ་ལྡན་འདས་ལ་ཞེ་སྡང་བའི་སེམས་བསྐྱེད་ནས་ཚེ་འཕོས་པའི་འོག་ཏུ་མནར་མེད་པའི་སེམས་ཅན་དམྱལ་བར་ལྷུང་བ་ལྟ་བུ་དང་། དཔེར་ན་། ཡུལ་སིན་དུ་ན་འོ་དོད་ཅན་ཞེས་བྱ་བའི་གྲོང་ཁྱེར་ཞིག་ཡོད་བར་རྒྱལ་པོའི་བུ་ཨཽ་ཏྲ་ཀ་ཞེས་བྱ་བས་ཕ་བསད་དེ་སེམས་ཅན་དམྱལ་བར་ལྷུང་བ་ལྟ་བུ་སྟེ་།
K10mkarmviu:528	 mātāpitṛṣu ca cittapradūṣaṇena narakagamanaṃ bhavati.	K10Dx_H0344:471a-0	དེ་ལྟར་ན་བཅོམ་ལྡན་འདས་དང་། ཕ་མ་ལ་ཞེ་སྡང་བར་བྱས་པའི་སེམས་༄༤༧༡ཨ་༌༎ ཀྱིས་སེམས་ཅན་དམྱལ་བར་འགྲོ་བར་འགྱུར་རོ་༎
K10mkarmviu:529	 j) tena kāraṇena kiṃ nāsti nānākaraṇam. ucyate. mahāntaṃ nānākaraṇam. bhagavān anekakalpaśatasahasropārjitakuśalamūlasaṃbhūtasaṃbhāraḥ	K10Dx_H0344:471a-2	དེ་དག་ལ་བྱེ་བྲག་མེད་པ་ཡིན་ནམ་ཞེ་ན་། བྱེ་བྲག་མེད་པའང་མ་ཡིན་ཏེ་། བཅོམ་ལྡན་འདས་ནི་བསྐལ་པ་བརྒྱ་སྟོང་དུ་མར་དགེ་བའི་རྩ་བ་བསྐྱེད་པ་། ཚོགས་བསགས་པ་།
K10mkarmviu:530	 anutpannasya mārgasyotpādayitā buddho bodhāya mārgaṃ deśayati. tasmin kṛtaḥ prasādo	K10Dx_H0344:471a-6	ལམ་མ་སྐྱེས་པ་རྣམས་ལ་ཆོས་སྟོན་ཅིང་བྱང་ཆུབ་ཏུ་སྟོབས་པ་སྟེ་།
K10mkarmviu:531	 'prameyaphalavipākaḥ ante ca nirvāṇam. mātāpitror mokṣamārgo 'viditaḥ. api ca na	K10Dx_H0344:471a-7	དེ་ལ་མོས་པ་བསྐྱེད་ན༏་འབྲས་བུ་རྣམ་པར་སྨིན་པ་ཚད་མེད་པར་འགྱུར་ཏེ་། དེ་མྱ་ངན་ལས་འདའ་བའི་ཚེ་ཡང་ཡབ་ཡུམ་ཐར་པའི་ལམ་ལ་བཀོད་དོ་༎
K10mkarmviu:532	 sarvaṃ mātāpitror vacanaṃ kāryam. santi kecin mithyādarśanopahatacittāḥ putrān bruvanti.	K10Dx_H0344:471a-9	དེ་ལྟ་ཡིན་ཡང་ཕ་མའི་ཚིག་ནི་ཐམས་ཅད་མཉན་པར་བྱ་བ་མ་ཡིན་ནོ་༎ དེ་ཅིའི་ཕྱིར་ཞེ་ན་། ལ་ལ་ལོག་པར་ལྟ་བ་དང་ལྡན་པ་དག་བུ་ལ་འདི་སྐད་ཅེས་ཟེར་ཏེ་།
K10mkarmviu:533	 ehi mām avasanaṃ naya. tava ca bhaviṣyati hitāya (MKV 59)	K10Dx_H0344:471a-12	བུ་། ངེད་ཁ་འཚོ་བའི་གནས་སུ་ཁྲིད་ཅིག་དང་། ཁྱོད་ལ་ཕན་པ་དང་། བདེ་བར་འགྱུར་རོ་ཞེས་ཟེར་བ་དང་། ངེད་ག-ཡང་དུ་ཐོངས་ཤིག་།
K10mkarmviu:534	 sukhāya mama ca. [prapāte māṃ pā]tayāgnau vā praveśayeti. tan naiva kartavyam. kiṃ	K10Dx_H0344:471a-13	མེར་ཆུགས་ཤིག་ཅེས་ཟེར་ཡང་དེ་ལྟ་བུ་ནི་མི་བྱའོ་༎ དེ་ཅིའི་ཕྱིར་ཞེ་ན་།
K10mkarmviu:535	 kāraṇam. mātāpitarau ghātayitvāvaśyaṃ narakagamanam. ata eva bhagavatā pratiṣiddho	K10Dx_H0344:471a-15	ཕ་མ་བསད་པས་ནི་གདོན་མི་ཟ་བར་སེམས་ཅན་དམྱལ་བར་འགྲོའོ་༎ དེ་ལྟ་བས་ན་བཅོམ་ལྡན་འདས་ཀྱིས་ཀྱང་ཕ་མ་གསོད་པ་ནི་རབ་ཏུ་འབྱུང་བར་མི་བྱ་སྟེ་།
K10mkarmviu:536	 na mātāpitṛghātakaḥ pravrājayitavyaḥ nāsti tasya pravrajyā nopasaṃpadā. nāsti phalaprāptiḥ.	K10Dx_H0344:471a-17	དེ་ལ་རབ་ཏུ་འབྱུང་བའི་རྒྱུ་མེད་། བསྙེན་པར་རྫོགས་པར་བྱ་བའི་རྒྱུ་མེད་དེ་།
K10mkarmviu:537	 evaṃvidhaṃ varjayitvānyathā samasamā mātāpitara ācāryopādhyāyāḥ. kathaṃ ca samasamā.	K10Dx_H0344:471a-19	དེ་ལྟ་བས་ན་དེ་དག་སྤང་བར་བྱའོ་ཞེས་གསུངས་ཏེ་། དེ་ལྟ་བས་ན་ཕ་མ་དང་། མཁན་པོ་དང་། སློབ་དཔོན་༄༤༧༡བ་དག་ཏུ་མཉམ་ཞིང་མཚུངས་པ་ཡིན་ཞེ་ན་།
K10mkarmviu:538	 nanu bhagavatoktam. mātāpitroḥ putrasneho yāvad asthimajjām āśritya tiṣṭhaty ata	K10Dx_H0344:471b-1	དེ་ནི་བཅོམ་ལྡན་འདས་ཀྱིས་ཕ་མ་བུ་ལ་བྱམས་པ་ནི་རྐང་དང་། རུས་པའི་ཁོང་ནས་བྱམས་སོ་ཞེས་གསུངས་ཏེ་། དེ་ལྟ་བས་ན་ཕ་མས་མ་གནང་ན་རབ་ཏུ་མི་འབྱུང་ངོ་༎ དེ་ཡང་དཔེར་ན་། འཕགས་པ་ཕོ་བྲང་འཁོར་སྐྱོང་ལ་སོགས་པ་ཕ་མས་མ་བཀྱེ་ན་བཅོམ་ལྡན་འདས་ཀྱིས་ཀྱང་རབ་ཏུ་མ་ཕྱུང་བ་ལྟ་བུ་སྟེ་།
K10mkarmviu:540	 bhagavatā mātāpitarāv ananujñāpya na pravrājitāḥ. adyāpi tān ananujñātān na pravrājayanti.	K10Dx_H0344:471b-5	ད་དུང་ཡང་ཕ་མས་མ་གནང་བར་རབ་ཏུ་མི་དབྱུང་སྟེ་། དཔེར་ན་། བཅོམ་ལྡན་འདས་རབ་ཏུ་བྱུང་བ་ལ་།
K10mkarmviu:541	 yathā ca bhagavati pravrajite śuddhodanasya putraśokena cakṣuṣī antarhite. ucyate.	K10Dx_H0344:471b-7	རྒྱལ་པོ་ཟས་གཙང་མ་སྲས་ཀྱི་མྱ་ངན་གྱི་མིག་རུབ་པར་གྱུར་པ་ལྟ་བུའི་ཕ་མས་ནི་བུ་འདི་བདག་ཅག་གིས་བསྐྱེད་བསྐྱེད་ཀྱི་།
K10mkarmviu:542	 mātāpitaraḥ pañca sthānāni pratyāśaṃsamānāḥ putram icchanti. śaṃvardhito no vṛddhībhūtān  pālayiṣyati kāryaṃ ca kariṣyati dravyasvāmī ca bhaviṣyati. kālagatānāṃ ca pitṛpiṇḍaṃ	K10Dx_H0344:471b-8	སྐྱེས་ནས་རིམ་གྲོར་བྱེད་པར་འགྱུར་རོ་༎ བདག་ཅག་གི་དགོས་པ་བསྒྲུབ་པར་འགྱུར་རོ་༎ ནོར་གྱི་བདག་པོར་འགྱུར་རོ༏་༏ཚེ་འཕོས་ན་ཡང་གཏོར་མ་བྱེད་པར་འགྱུར་རོ་༎ རིགས་ཀྱི་རྒྱུད་འཚོབ་པར་འགྱུར་རོ་ཞེས་གནས་ལྔ་པོ་དེ་དག་ལ་རེ་ཞིང་ཕ་མ་བུ་འདོད་དོ་༎
K10mkarmviu:544	 dāsyati. kulavaṃśaś ca cirasthitiko bhaviṣyati. imāni pañca sthānāni pratyāśaṃsamānā  mātāpitaraḥ putram icchanti. naivam ācāryopādhyāyāḥ. kevalam eva kāruṇyaṃ puraskṛtya	K10Dx_H0344:471b-12	མཁན་པོ་དང་། སློབ་དཔོན་ནི་སྙིང་རྗེའི་སེམས་སྔོན་དུ་བཏང་ཞིང་ཇི་ལྟར་ན་ཐོག་མ་མེད་པ་ནས་འཁྱམ་འཁྱམ་པ་འདི་ད་དུང་ཕ་མས་མ་གནང་ན་རབ་ཏུ་མི་འབྱུང་གི་བར་དུ་ཕྱིན་པར་བྱ་སྙམ་སེམས་ཏེ་།
K10mkarmviu:546	 katham asyā nādikālapravṛttasya saṃsāracakrasya paryantaṃ kuryād iti. yathā bhagavatā	K10Dx_H0344:471b-13	དཔེར་ན༏་བཅོམ་ལྡན་འདས་ཀྱིས་འདུལ་བ་ལས་གསུངས་པ་།
K10mkarmviu:547	 vinaya uktam. upādhyāyasya śiṣye putrasaṃjñā bhavati. śiṣyasyāpy upādhyāye pitṛsaṃjñā	K10Dx_H0344:471b-14	མཁན་པོ་ནི་སློབ་མ་ལྟ་བུའི་འདུ་ཤེས་འཇོག་གོ་། སློབ་མ་ནི་མཁན་པོ་ལ་ཕའི་འདུ་ཤེས་འཇོག་གོ་།
K10mkarmviu:548	 bhavati. evam anyonyaniśritāḥ sukhino bhaviṣyanti. evam ācāryopādhyāyāḥ samasamā  mātāpitṛbhiḥ. yathā cakravartisūtra (MKV 60)	K10Dx_H0344:472a-0	དེ་བཞིན་དུ་ཕན་༄༤༧༢ཨ་༌༎ ཚུན་ཕ་མ་དང་། བུའི་འདུ་ཤེས་འཇོག་གོ་ཞེས་གསུངས་པ་ལྟ་བུ་སྟེ་། དེ་ལྟར་ན་མཁན་པོ་དང་། སློབ་དཔོན་ནི་ཕ་མ་དང་མཚུངས་ཤིང་མཉམ་མོ་༎
K10mkarmviu:550	 uktaṃ bhagavatā. kasya karmaṇo vipākena rājā cakravartī hastiratnāny aśvaratnāni	K10Dx_H0344:472a-3	དེ་ཡང་བཅོམ་ལྡན་འདས་ཀྱིས་འཁོར་ལོས་བསྒྱུར་བའི་མདོ་ལས་གསུངས་པ་། ལས་ཀྱི་རྣམ་པར་སྨིན་པ་གང་གིས་འཁོར་ལོས་བསྒྱུར་བའི་རྒྱལ་པོ་གླང་པོ་རིན་པོ་ཆེ་དང་། རྟ་རིན་པོ་ཆེ་འཐོབ་ཅེ་ན་།
K10mkarmviu:551	 ca pratilabhate. dīrgharātraṃ rājā cakravartī mātaraṃ pitaraṃ vā svayaṃ vā skandhe  vahati vā rathādibhir vāhayati vā. ācāryopādhyāyān svayaṃ vahati vāhayati vā. tasya  karmaṇo vipākena rājā cakravartī hastyaśvaratnāni pratilabhate. anenāpi kāraṇena	K10Dx_H0344:472a-5	དེ་ནི་ཕ་མ་ཁུར་དུ་ཁྱེར་ཁྱེར་པ་དང་། གླང་པོ་དང་། རྟ་དང་། ཤིང་རྟ་ལ་སོགས་པ་ལ་བསྐྱོན་པ་དང་། མཁན་པོ་དང་། སློབ་དཔོན་བདག་གིས་བཀུར་བ་དང་། གཞན་ལ་བསྐྱོན་པའི་ལས་ཀྱི་རྣམ་པར་སྨིན་པས་འཁོར་ལོས་བསྒྱུར་བའི་རྒྱལ་པོ་གླང་པོ་དང་།
K10mkarmviu:554	 samasamā mātāpitara ācāryopādhyāyāś ca. api tv asty anyatra nānākaraṇam. gṛhasthānāṃ	K10Dx_H0344:472a-7	རྒྱུ་དེས་ཀྱང་ཕ་མ་དང་། མཁན་པོ་དང་། སློབ་དཔོན་དག་ཏུ་མཚུངས་ཤིང་མཉམ་མོ་༎
K10mkarmviu:555	 mātāpitṛ pravrajitāḥ pūjyāḥ. pravrajitānām ācāryopādhyāyā eva pūjanīyāḥ. yathā mahīśāsakā  gotrāntarīyā vinaye 'rthotpattiṃ dhārayanti. yathāha bhagavān. na bhikṣavaḥ ācāryopādhyāyān  anāpṛṣṭvā deśāntaraṃ gantavyam. kasmād. bhavati bhikṣavo jīvitāntarāyo bhavati brahmacaryāntarāyo  bhavati pātracīvarāntarāyaḥ. bhūtapūrvaṃ bhikṣavo maitrāyajño nāma sārthavāhaputra	K10Dx_H0344:472a-8	དེ་ལའང་ཁྱིམ་པ་དག་ལ་ནི་ཕ་མ་མཆོད་པའི་གནས་ཡིན་ནོ་༎
K10mkarmviu:559	 āsīd iti. etad evāvadānaṃ yathāvasthitaṃ vaktavyam. evam eva samasamā ācāryopādhyāyā	K10Dx_H0344:472a-9	རབ་ཏུ་བྱུང་བ་རྣམས་ལ་ནི་མཁན་པོ་དང་། སློབ་དཔོན་མཆོད་པའི་གནས་ཡིན་ནོ་༎ དེ་ལྟར་ན་མཁན་པོ་དང་། སློབ་དཔོན་དང་། ཕ་མར་མཚུངས་ཤིང་མཉམ་པ་ཡིན་ནོ་ཞེས་གསུངས་པ་ལྟ་བུའོ་༎
K10mkarmviu:560	 mātāpitaraś ca. yathā coktaṃ bhagavatā. yo bhikṣavo mātāpitarau skandhena gṛhya jambudvīpaṃ	K10Dx_H0344:472a-11	དཔེར་ན་། བཅོམ་ལྡན་འདས་ཀྱིས་དགེ་སློང་དག་ལ་བཀའ་སྩལ་པ་། དགེ་སློང་དག་།
K10mkarmviu:561	 paryaṭeta yogodvahanaṃ ca kuryāt caturṣu (MKV 61)  pratiṣṭhāpayet. evaṃ mātāpitṝṇāṃ putraiḥ pratyupakāraḥ kṛto bhavati. tac ca sarvam  ācāryopādhyāyāḥ kurvanti. yathāha bhagavān dakṣiṇāvibhaṅgasūtre. yathānanda pudgalaḥ	K10Dx_H0344:472b-0	ལ་ལ་ཞིག་གིས་ཕ་མ་ཕྲག་པ་ལ་བླངས་ཏེ་འཛམ་བུའི་གླིང་བསྐོར་བ་དང་། འཚོ་བ་ཐམས་ཅད་སྦྱར་བ་དང་། གླིང་བཞི་༄༤༧༢བ་ཐམས་ཅད་ནོར་དབྱིག་དང་གསེར་གྱིས་བཀང་སྟེ་བྱིན་ཡང་ཕ་མ་ལ་ཕན་པའི་ལན་ལོན་པར་མི་འགྱུར་གྱི་།
K10mkarmviu:566	 pudgalam āgamya buddhaṃ śaraṇaṃ gacchati dharmaṃ saṃghaṃ śaraṇaṃ gacchati yathoktāni	K10Dx_H0344:472b-1	ལ་ལ་ཞིག་གིས་སངས་རྒྱས་ལ་དད་པ་བསྐྱེད་པ་དང་། ཆོས་དང་། དགེ་འདུན་ལ་དད་པ་བསྐྱེད་པ་དང་། བསླབ་པ་ལྔ་ལ་གཞག་པ་དང་། འཕགས་པས་བསྔགས་པའི་ལམ་ལ་སྐྱབས་སུ་གཏོང་བའི་གང་ཟག་དེ་ལ་ནི་གུས་པར་སྨྲས་པ་དང་།
K10mkarmviu:568	 yad idam abhivādanapratyutthānamātreṇaivam api prativiśiṣṭatarā ācāryopādhyāyā mātāpitṛbhyām.	K10Dx_H0344:472b-3	དེ་ལྟར་ན་ཕ་མ་བས་ཀྱང་མཁན་པོ་དང་། སློབ་དཔོན་ཁྱད་པར་དུ་འཕགས་སོ་༎
K10mkarmviu:583	 putram icchanti. ācāryopādhyāyās tu kāruṇyān nirvāṇaṃ dharmaṃ deśayanti. anenāpi  kāraṇena mātāpitṛbhya ācāryopādhyāyāḥ prativiśiṣṭatarā	K10Dx_H0344:472b-7	དགེ་བསྙེན་མ་ཇི་སྙེད་ཅིག་མངོན་པར་མོས་པ་དང་། དུལ་བར་གྱུར་པ་དེ་དག་ཐམས་ཅད་ཀྱང་མཁན་པོ་དང་། སློབ་དཔོན་གྱིས་མངོན་པར་མོས་ཤིང་དུལ་བར་བྱས་སོ་༎
K10mkarmviu:585	 iti. ata evam āha bhagavān. mama bhikṣavo vacanaṃ śraddadhānair bhagavati paraḥ prasādaḥ	K10Dx_H0344:472b-8	དེའི་ཕྱིར་བཅོམ་ལྡན་འདས་ཀྱིས་གསུངས་པ་། དགེ་སློང་དག་། དེའི་ཚིག་ལ་ཡིད་ཆེས་པ་རྣམས་ཀྱིས་སངས་རྒྱས་བཅོམ་ལྡན་འདས་ལ་དད་པ་མཆོག་བསྐྱེད་པར་བྱའོ་༎
K10mkarmviu:586	 kāryaḥ dharme saṃghe mātāpitṛṣv ācāryopādhyāyeṣu paraḥ prasādaḥ kāryaḥ. tad vo bhaviṣyati	K10Dx_H0344:472b-11	ཆོས་དང་། དགེ་འདུན་དང་། ཕ་མ་དང་། མཁན་པོ་དང་། སློབ་དཔོན་ལ་དད་པ་མཆོག་བསྐྱེད་པར་བྱའོ་༎
K10mkarmviu:587	 dīrgharātraṃ hitāya sukhāyeti. idaṃ karma deśāntaravipākam.  (MKV 65)	K10Dx_H0344:473a-0	དེ་ནི་ཁྱོད་ལ་ཡུན་རིང་པོར་ཕན་པ་དང་། བདེ་བའི་༄༤༧༣ཨ་༌༎ ལས་དེ་ལྟ་བུ་ནི་ཡུལ་གཞན་དུ་རྣམ་པར་སྨིན་པར་འགྱུར་རོ་༎
K10mkarmviu:589	 XXXIII. katamat karma yena samanvāgataḥ pudgalaḥ pūrvaṃ sukhito bhūtvā paścād duḥkhito	K10Dx_H0344:473a-3	དེ་ལ་ལས་གང་དང་ལྡན་ན་གང་ཟག་སྔར་བདེ་བར་གྱུར་ལ་། ཕྱིས་སྡུག་བསྔལ་བར་འགྱུར་བའི་ལས་ཡོད་དེ་། དེ་གང་ཞེ་ན་།
K10mkarmviu:590	 bhavati. ucyate. ihaikatyo dānaṃ yācitaḥ samānaḥ pūrvaṃ prahṛṣṭaḥ pratijānīte pramudito	K10Dx_H0344:473a-6	བཤད་པར་བྱ་སྟེ་། འདི་ལ་ལ་ལ་ཞིག་སྦྱིན་པ་བསླངས་ན་རབ་ཏུ་དགའ་སྟེ་། ཁས་ལེན་ཅིང་རབ་ཏུ་དགའ་བས་བྱིན་ལ་།
K10mkarmviu:591	 dadāti. dattvā ca khalu pratisārī bhavati. sa yadā manuṣyeṣūpapadyate. āḍhyeṣu mahādhaneṣu  mahābhogeṣu kuleṣūpapadyate. paścāt tasya te bhogāḥ parikṣayaṃ paryādānaṃ gacchanti.	K10Dx_H0344:473a-9	བྱིན་ནས་དེའི་འོག་ཏུ་འགྱོད་པ་ཡིན་ཏེ་། དེ་ནས་མིར་སྐྱེས་ན་ཡང་ཕྱུག་ཅིང་ལོངས་སྤྱོད་ཆེ་བའི་རིགས་སུ་སྐྱེ་སྟེ་། ལོངས་སྤྱོད་དེ་དག་ཕྱིས་ཟད་ཅིང་དེངས་པར་འགྱུར་རོ་༎
K10mkarmviu:593	 sa paścād daridro bhavati. yathāryagopakaḥ. tena kila kakucchande samyaksaṃbuddhe	K10Dx_H0344:473a-12	དེ་ཕྱིས་དབུལ་པོར་འགྱུར་བ་ནི་ཁྱེའུ་གྲགས་པ་ཞེས་བྱ་བ་བཞིན་ཏེ་། དེས་ཡང་དག་པར་རྫོགས་པའི་སངས་རྒྱས་ལོག་པར་དད་སེལ་དང་། དགེ་སློང་གི་དགེ་འདུན་ལ་བ་བཞོན་གཅིག་ཕུལ་ནས་།
K10mkarmviu:594	 bhikṣusaṃghasya godhenur dattā. sa paścāt parair garhito na sādhukṛteyaṃ datteti.	K10Dx_H0344:473a-14	དེ་ཕྱིས་གཞན་དག་གིས་འགྱོད་བཏབ་པ་དང་། དེ་ལྟར་བྱིན་པ་ནི་མ་ལེགས་པ་ཞིག་བྱས་སོ་སྙམ་ནས་།
K10mkarmviu:595	 tena cittaṃ pradūṣitam. sa yatra yatropapadyate tatra tatra mahādhano bhavati. paścāt	K10Dx_H0344:473a-15	དེ་སེམས་ལ་འགྱོད་པ་སྐྱེས་པས་དེ་གར་སྐྱེས་ཀྱང་ཐོག་མ་ཕྱུག་པོར་ནི་གྱུར་ན་།
K10mkarmviu:596	 tena cittapradoṣeṇa daridro bhavati. paścime bhave 'pi rājagṛhe nagare (MKV 66)	K10Dx_H0344:473a-16	ཕྱིས་སེམས་འགྱོང་བ་སྐྱེས་པ་དེས་ཐ་མར་དབུལ་པོར་གྱུར་ཏོ་༎
K10mkarmviu:597	 'nyatarasmin gṛhe pratyājātaḥ. tasya jāyamānasya mātā kālagatā. anena mātā māritā	K10Dx_H0344:473a-17	དེ་ཕྱིས་རྒྱལ་པོའི་ཁབ་ཏུ་སྐྱེས་ཏེ་། སྐྱེ་བ་ན་དེའི་མ་ཚེ་འཕོས་པར་གྱུར་པ་དང་། འདི་སྐྱེས་པས་མ་ཡང་ཚེ་འཕོས་ཏེ་།
K10mkarmviu:598	 jāyamānena mūlanakṣatre jāto 'yaṃ mā nirmūlaṃ kulaṃ kariṣyaty amaṅgalo 'yam iti mātrā	K10Dx_H0344:473a-19	འདི་ནི་སྐར་མ་སྣུབས་ལས་སྐྱེས་པས་རིགས་ཕུང་པར་བྱེད་པར་འགྱུར་ཏེ་། ༄༤༧༣བ་འདི་ནི་བཀྲ་མི་ཤིས་སོ་ཞེས་ནས་མ་དང་ལྷན་ཅིག་ཏུ་དུར་ཁྲོད་དུ་བོར་རོ་༎
K10mkarmviu:599	 sārdhaṃ śmaśāne utsṛṣṭaḥ. tatrāpi ca mātur ekastanāt kṣīraṃ pragharati tenaiva puṇyānubhāvena.	K10Dx_H0344:473b-1	དེ་ན་ཡང་དེའི་བསོད་ནམས་ཀྱི་མཐུས་མའི་ནུ་མ་ཡ་གཅིག་ནས་འོ་མ་བྱུང་སྟེ་།
K10mkarmviu:600	 vivṛddhaś ca bhagavatāgatya pravrājitaḥ. etac ca sarvam anupūrveṇa bhagavatā bhikṣūṇāṃ	K10Dx_H0344:473b-2	དེས་གསོས་ནས་ཆེར་སྐྱེས་པ་དང་། བཅོམ་ལྡན་འདས་ཀྱི་གན་དུ་སོང་སྟེ་རབ་ཏུ་བྱུང་ངོ་༎
K10mkarmviu:601	 kathitam. evam anena pūrvaṃ kṣīradhenuḥ prasādajātena dattā paścād vipratisārī saṃvṛttaḥ.  tasyedaṃ karmaphahm. yas tv asau pūrvakaś cittaprasādas tad evāsya mokṣabījam. yathā	K10Dx_H0344:473b-3	ད་ལྟར་དེས་སྔར་དད་པ་སྐྱེས་ཏེ་བ་བཞོན་ཕུལ་ལ་ཕྱིས་འགྱོད་པར་གྱུར་པས་ལས་དེའི་འབྲས་བུས་སྔར་སེམས་དད་པས་ཕུལ་བས་ནི་དེ་ཉིད་དེའི་ཐར་བའི་ས་བོན་དུ་གྱུར་ཏོ་༎
K10mkarmviu:603	 ca campāyāṃ mahānagaryām īśvaro gṛhapatiputraḥ. tena bhṛtyānāṃ haste sarvaṃ dhanaṃ  caturdiśaṃ bāṇijyāya preṣitam. tac ca sarvaṃ deśāntaragataṃ vinaṣṭam. sa ca parakarmakaraḥ	K10Dx_H0344:473b-4	ཕྱིས་འགྱོད་པས་ནི་ཐ་མ་དབུལ་པོར་གྱུར་པ་ལྟ་བུ་སྟེ་།
K10mkarmviu:605	 saṃvṛttaḥ. idaṃ karma yena samanvāgataḥ pudgalaḥ pūrvaṃ sukhito bhūtvā paścād duḥkhito bhavati.  XXXIV. katamat karma yena samanvāgataḥ pudgalaḥ pūrvaṃ duḥkhito bhūtvā paścāt sukhito	K10Dx_H0344:473b-5	འདི་ནི་ལས་གང་དང་ལྡན་ན་གང་ཟག་སྔར་བདེ་ལ་ཕྱིས་སྡུག་བསྔལ་བར་འགྱུར་བའོ་༎ དེ་ལ་ལས་གང་དང་ལྡན་ན་ན་གང་ཟག་སྔར་སྡུག་བསྔལ་ལ་ཕྱིས་བདེ་བར་འགྱུར་བའི་ལས་ཡོད་དེ་། དེ་གང་ཞེ་ན་།
K10mkarmviu:607	 bhavati. ucyate. ihaikatyo dānaṃ samādāya yācitaḥ samānaḥ pratijānīte. kṛcchreṇa	K10Dx_H0344:473b-8	བཤད་པར་བྱ་སྟེ་། འདི་ལ་ཁ་ཅིག་སྦྱིན་པ་བྱེད་དུ་བཅུག་ན་ཁ་སྲ་བ་ལས་ཁས་ལེན་ཅིང་། ཁ་སྲ་བཞིན་དུ་སྦྱིན་པ་བྱེད་ལ་།
K10mkarmviu:608	 dadāti. dattvā tu dānaṃ paścāt prītim utpādayati. sa yadā manuṣyeṣūtpadyate daridreṣu  kuleṣūtpadyate. tasya paścāt te bhogā abhivṛddhiṃ gacchanti. atra cāniruddhasyāvadānaṃ	K10Dx_H0344:473b-11	སྦྱིན་པ་བྱིན་པའི་འོག་ཏུ་སེམས་དགའ་བ་སྐྱེད་དོ་༎ དེ་ནི་མིའི་ནང་དུ་སྐྱེས་ན་དབུལ་པོའི་རིགས་སུ་སྐྱེས་ཏེ་ཕྱིས་ལོངས་སྤྱོད་དེ་དག་འཕེལ་བར་འགྱུར་རོ་༎
K10mkarmviu:627	 bhavati. idaṃ karma yena samanvāgataḥ pudgalaḥ pūrvaṃ duḥkhito bhūtvā paścāt sukhito bhavati.  XXXV. katamat karma yena samanvāgataḥ pudgalaḥ pūrvaṃ ca paścāc ca sukhito bhavati.	K10Dx_H0344:474a-1	སྔར་ཡང་བདེ་ལ་ཕྱིས་ཀྱང་བདེ་བར་འགྱུར་བའི་ལས་ཡོད་དེ་། དེ་གང་ཞེ་ན་།
K10mkarmviu:629	 ucyate. ihaikatyo dānaṃ yācitaḥ sa prahṛṣṭaḥ pratijānīte prahṛṣṭo dadāti. dattvāpi	K10Dx_H0344:474a-3	ཁ་ཅིག་བསླངས་མ་ཐག་ཏུ་དགའ་ཞིང་ཁས་ལེན་། དགའ་བཞིན་དུ་སྦྱིན་པ་བྱིན་ནས་ཀྱང་དགའ་བར་འགྱུར་རོ་༎
K10mkarmviu:630	 ca prītimān bhavati. sa yadā manuṣyeṣūpapadyate. āḍhyeṣu kuleṣūpapadyate mahādhaneṣu  mahābhogeṣu. atra bhadrike nagare miṇḍhakaprabhṛtīnāṃ caturṇāṃ dānapatīnāṃ vipāko  vaktavyaḥ. taiḥ kila tagaraśikhī pratyekabuddhaḥ piṇḍapātena pratipādilaḥ. atra vinayāvadānaṃ  vaktavyam. idaṃ karma yena samanvāgataḥ pudgalaḥ pūrvaṃ ca paścāc ca sukhito bhavati.  XXXVI. katamat karma yena samanvāgataḥ pudgalaḥ pūrvaṃ ca paścāc ca duḥkhito bhavati.	K10Dx_H0344:474a-5	དེ་ནས་མིའི་ནང་དུ་སྐྱེས་ན་ཕྱུག་ཅིང་ལོངས་སྤྱོད་ཆེ་བའི་རིགས་སུ་སྐྱེའོ་༎
K10mkarmviu:436	 pūrvapuruṣo 'sti. pūrvaṅgamaṃ kṛtvā deśāntarāṇi gatvā dravyopārjanāni kurvanti. suvarṇabhūmiṃ	K10Dx_H0344:465a-21	གླིང་གཞན་དག་ཀྱང་ལྟ་ཞིང་ནོར་ལ་སོགས་པ་ཡང་བྱེད་ན་།
K10mkarmviu:437	 siṃhaladvīpaṃ ca prabhṛtīni ca dvīpāntarāṇi paśyanti. vayam  api tvayā pūrvaṅgamena deśāntaraṃ paśyāma iti. vayam api gacchāma iti pratiśrutam.  so 'haṃ gṛhaṃ gatvā mātaram āpṛṣṭavān. aham evaṃ deśāntaraṃ gamiṣyāmīti. mātā ma  āha. putra tava pitā samudram avatīrṇo deśāntaraṃ gata eva kālagataḥ. tvam ekaputrakaḥ.	K10Dx_H0344:465b-0	ཁྱོད་ལ་སོགས་༄༤༦༥བ་པ་བདག་ཅག་ཀྱང་རྒྱ་མཚོ་ལས་རྒྱུས་ཏེ་ནོར་བསགས་པར་བྱའོ་ཞེས་སྨྲས་པ་དང་། དེས་དེ་ལྟར་བྱའོ་ཞེས་མཉན་ཏེ་དགོངས་མའི་གན་དུ་སོང་ནས་། མ་གསེར་གནས་སུ་འགྲོའོ་ཞེས་མ་ལ་དྲིས་པ་དང་། དེའི་མས་སྨྲས་པ་།
K10mkarmviu:441	 prabhūtaṃ gṛhe dravyaṃ tiṣṭhati. na gantavyam. iti. mayā na gacchāmīti pratiśrutam.	K10Dx_H0344:465b-2	བུ་། ནོར་ལྟ་ཞིག་ཁྱིམ་ན་དཔག་ཏུ་མེད་པ་ཡོད་ཀྱི་མ་འགྲོ་ཞིག་ཅེས་སྨྲས་པ་དང་། དེས་མའི་དག་མཉན་ཏེ་།
K10mkarmviu:442	 evaṃ dvitīyaṃ tṛtīyaṃ caturtham apy āpādapatanaṃ nivartitaḥ. kālāntareṇāhaṃ bhūyo	K10Dx_H0344:465b-3	མི་འགྲོ་བར་བྱས་ནས་དེའི་འོག་ཏུ་བཟའ་ཤིང་གི་ར་བར་ཕྱིན་པ་དང་། གྲོགས་པོ་རྣམས་ཀྱིས་དོན་དེ་ཉིད་ལ་ད་དུང་ཡང་གསོལ་བ་འདེབས་སོ་ཞེས་སྨྲས་པ་དང་། དེས་དེ་ལྟར་བྱའོ་ཞེས་ནས་དེ་དག་གི་ངག་མཉན་ཏེ་། ཡང་སོང་ནས་མ་ལ་དྲིས་པ་དང་། མས་རྐང་པ་ནས་བཟུང་སྟེ་འདུག་པར་གྱུར་ནས་དེ་ལྟར་ལན་གསུམ་བྱས་པའི་འོག་ཏུ་བཟའ་ཤིང་གི་ར་བ་དེར་ཕྱིན་པ་དང་། གྲོགས་པོ་རྣམས་ཀྱིས་ངེས་པར་མི་འདོང་དུ་མི་རུང་ངོ་ཞེས་བསྒོ་ནས་། དེས་ཡང་མ་ལ་ཡུལ་གཞན་དུ་འགྲོའོ་ཞེས་ཞུས་པ་དང་། མས་བདོག་པ་ཐམས་ཅད་བསོག་ནས་རྐང་པ་ཡ་གཅིག་ནས་བཟུང་སྟེ་མི་འགྲོ་བར་བྱས་པ་ལས་།
K10mkarmviu:443	 'py udyānaṃ gataḥ sahāyair uktaḥ. avaśyaṃ gantavyam iti. gamiṣyāmīti mayā pratiśrutam.	K10Dx_H0344:465b-6	དུས་གཞན་ཞིག་ན་ཁྱེའུ་དེ་བཟའ་ཤིང་གི་ར་བ་དེར་ཕྱིན་པ་དང་། གྲོགས་པོ་དག་གིས་སྨྲས་པ་། ཁྱོད་ཀྱིས་ཉེས་པས་བདག་ཅག་ཀྱང་ད་དུང་མ་དོང་སྟེ་།
K10mkarmviu:444	 atha mama prasthitasya mātā dvāre pādapatanaṃ kṛtvā sthitā. putra nārhasi māṃ parityaktum	K10Dx_H0344:466a-0	ད་ནི་ཚེས་བཅུ་གསུམ་ལ་འདོང་ངོ་ཞེས་སྨྲས་པ་དང་། དེས་མ་ལ་མ་བྱས་པར་རྒྱ་རྫས་ཐམས་ཅད་ཕྱིར་བཏོན་ནས་དེ་ལམ་དུ་འཇུག་པར་བྱས་༄༤༦༦ཨ་༌༎ པ་དང་། དེའི་མས་སྒོ་ཁར་བསྡད་དེ་རྐང་པ་ནས་བཟུང་བ་དང་། བུ་།
K10mkarmviu:445	 iti. tasyāhaṃ mastake pādaṃ dattvā prakrāntaḥ. so 'haṃ pañcabhiḥ sahāyaśataiḥ sārdhaṃ	K10Dx_H0344:466a-2	མ་འགྲོ་ཞིག་ཅེས་བྱས་པ་དང་། དེ་ཁྲོས་ནས་མའི་མགོ་ལ་འགོམས་ཏེ་སོང་ནས་རྒྱ་མཚོའི་ངོགས་སུ་ཕྱིན་པ་དང་། དེས་གྲོགས་པོ་རྣམས་ལ་བསྒོ་བ་། རྒྱ་མཚོར་འཇུག་པར་ནི་བྱ་ན་འཚོའམ་།
K10mkarmviu:446	 samudrakūlaṃ gataḥ. aṣṭāṅgasamanvāgataṃ poṣadhaṃ gṛhya samudram avatīrṇaḥ. suvarṇabhūmiprasthitānām	K10Dx_H0344:466a-4	མི་འཚོར་ཡང་གཏོལ་མེད་ཀྱི་བདག་ཅག་ཀུན་གྱིས་ཁྲིམས་བརྒྱད་གནོད་པར་བྱའོ་ཞེས་སྨྲས་ནས་། དེ་དག་གིས་ཀྱང་དེའི་དག་མཉན་ཏེ་ཁྲིམས་མནོས་སོ་༎ དེ་ལྟར་དེ་དག་རྒྱ་མཚོར་ཞུགས་ཏེ་དོང་དོང་བ་ལས་དབུས་སུ་ཕྱིན་པ་དང་རླུང་ཆེན་པོ་ལངས་ནས་གྲུ་བུབ་སྟེ་།
K10mkarmviu:447	 asmākaṃ viṣamavātādyāhataḥ poto vinaṣṭaḥ. te sarve kālagatāḥ. ahaṃ tu bahubhir divasaiḥ	K10Dx_H0344:466a-7	གཞན་ཐམས་ཅད་ནི་ཚེ་འཕོས་། བྱམས་པ་མཆོད་སྦྱིན་ནི་ཟངས་ཀྱི་རལ་ཆེན་ཁ་སྐྱ་འདར་གྱིས་བཅད་པ་ཞིག་ལ་། འཇུ་འཇུ་ནས་རྒྱ་མཚོ་མཐར་ཕྱིན་ཏེ་འཕྱན་ཅིང་སོང་སོང་ན་།
K10mkarmviu:448	 kathaṃcana samudrād uttīrṇo 'tha prapīḍyamānaḥ sauvarṇena prākāreṇa nagaram. ārāmasaṃpannam.	K10Dx_H0344:466a-10	གྲོང་ཁྱེར་གསེར་གྱི་ར་བ་ཅན་བཟའ་ཤིང་གི་ར་བ་དང་ལྡན་པ་།
K10mkarmviu:680	 ayaṃ pudgala āḍhyo bhavati matsarī.	K10Dx_H0344:474b-6	ཡང་གཏོང་བ་ལ་སེམས་གོམས་པ་མ་ཡིན་པ་སྟེ་། ལས་དེས་ཕྱུག་ལ་སེར་སྣ་ཅན་དུ་འགྱུར་རོ་༎ གང་ཟག་འདི་ནི་ལས་གང་དང་ལྡན་ན་ཕྱུག་ཅིང་སེར་སྣ་ཅན་དུ་འགྱུར་བའོ་༎
K10mkarmviu:681	 XXXVIII. katamat karma yena samanvāgataḥ pudgalo daridro bhavati tyāgavān. ucyate.	K10Dx_H0344:474b-9	དེ་ལ་གང་ཟག་ལས་གང་དང་ལྡན་ན་། དབུལ་ཞིང་གཏོང་ཕོད་པར་འགྱུར་བའི་ལས་ཡོད་དེ་། དེ་གང་ཞེ་ན་།
K10mkarmviu:682	 ihaikatyena pudgalena bahu dānaṃ dattaṃ bhavati. tiryaggateṣu manuṣyeṣu ca duḥśīleṣv	K10Dx_H0344:474b-12	འདི་ལ་གང་ཟག་ཁ་ཅིག་དུད་འགྲོ་དང་། མི་ལོག་པའི་ངང་ཚུལ་ཅན་ལ་སྦྱིན་པ་མང་དུ་བྱིན་པ་ཡིན་ཏེ་།
K10mkarmviu:683	 abrahmacāriṣu. punaḥ punas tyāgacittam abhyastam. sa yadā manuṣyeṣūpapadyate daridro  bhavati tyāgavān tena dānābhyāsena. yat tu tenāpātrabhūteṣu dānaṃ dattaṃ tena daridraḥ.	K10Dx_H0344:474b-13	དེ་ནམ་མིའི་ནང་དུ་སྐྱེས་ནའང་དབུལ་ཞིང་གཏོང་ཕོད་པར་འགྱུར་བ་ནི་སྔོན་སྦྱིན་པ་ལ་གོམས་པས་དབུལ་ཡང་གཏོང་ཕོད་པར་འགྱུར་རོ་༎
K10mkarmviu:685	 yathā śrāvastyāṃ tatra vinaye tantravāyasya nidānaṃ varṇayanti. sa tyāgavān daridraś  ca. punaḥ punas tyāgacittam abhyastam. idaṃ karma yena samanvāgataḥ pudgalo daridro bhavati tyāgavān.	K10Dx_H0344:474b-14	འདི་ནི་གང་ཟག་ལས་གང་དང་ལྡན་ན་དབུལ་ཞིང་གཏོང་ཕོད་པར་འགྱུར་བའོ་༎
K10mkarmviu:687	 XXXIX. katamat karma yena samanvāgataḥ pudgala āḍhyo bhavati tyāgavān. ucyate. ihaikatyena	K10Dx_H0344:474b-15	དེ་ལ་གང་ཟག་ལས་གང་དང་ལྡན་ན་། ཕྱུག་ཅིང་གཏོང་ཕོད་པར་འགྱུར་བའི་ལས་ཡོད་དེ་། དེ་གང་ཞེ་ན་།
K10mkarmviu:688	 pudgalena bahu dānaṃ dattaṃ bhavati śīlavatsu pātrabhūteṣu. punaḥ punas tyāgacittam	K10Dx_H0344:474b-18	འདི་ལ་གང་ཟག་ཁ་ཅིག་གིས་ཚུལ་ཁྲིམས་དང་ལྡན་པ་སྦྱིན་གནས་སུ་གྱུར་པ་དག་ལ་སྦྱིན་པ་མང་དུ་བྱས་པ་ཡིན་། སྦྱིན་པ་ལ་སེམས་གོམས་པ་༄༤༧༥ཨ་༌༎
K10mkarmviu:689	 abhyastaṃ bhavati. sa tena karmaṇā yadā manuṣyeṣūpapadyate. āḍhyeṣu kuleṣūpapadyate  mahādhaneṣu mahābhogeṣu. yat tu tena punaḥ punas tyāgacittam abhyastaṃ tena tyāgavān	K10Dx_H0344:475a-1	ཡིན་ཏེ་། དེ་ལས་དེས་མིའི་ནང་དུ་སྐྱེས་ན་ཡང་ཕྱུག་ཅིང་ལོངས་སྤྱོད་ཆེ་བར་འགྱུར་ཏེ་།
K10mkarmviu:691	 bhavati. yathānāthapiṇḍadena kila krakucchande samyaksaṃbuddhe jetavanaṃ niryātitam.	K10Dx_H0344:475a-2	དཔེར་ན་། ཁྱིམ་བདག་མགོན་མེད་ཟས་བྱིན་པ་ལྟ་བུའོ་༎ དེས་ཡང་དག་པར་རྫོགས་པའི་སངས་རྒྱས་ལོག་པར་དད་སེལ་ལ་རྒྱལ་བུ་རྒྱལ་བྱེད་ཀྱི་ཚལ་ཕུལ་། གཙུག་ལག་ཁང་བརྩིགས་པ་།
K10mkarmviu:692	 vihāraś ca kāritaḥ. evaṃ kanakamunau samyaksaṃbuddhe kāśyape sarvārthasiddhe ca.  bhūyaś ca maitreyasya suvarṇāstīrṇaṃ niryātayiṣyati. idaṃ karma yena samanvāgataḥ  pudgala āḍhyo bhavati tyāgavān.	K10Dx_H0344:475a-5	དེ་བཞིན་དུ་ཡང་དག་པར་རྫོགས་པའི་སངས་རྒྱས་གསེར་ཐུབ་དང་། འོད་སྲུང་དང་། དོན་ཐམས་ཅད་གྲུབ་པ་དང་། བྱམས་པ་ལ་གསེར་གྱི་ཡག་མག་བཏིང་བ་ཕུལ་བ་ལྟ་བུ་སྟེ་། འདི་ནི་གང་ཟག་ལས་གང་དང་ལྡན་པ་ཕྱུག་ཅིང་གཏོང་ཕོད་པར་འགྱུར་བའོ་༎
K10mkarmviu:695	 XL. katamasya pudgalasyāyuḥ kṣīṇaṃ na karma. ucyate. yaḥ pudgalo narakāc cyuto narakeṣūpapadyate. tiryagbhyaś cyutas (MKV 72)	K10Dx_H0344:475a-7	དེ་ལ་གང་ཟག་ལ་ལ་ཚེ་ཟད་ལ་ལས་མ་ཟད་པ་ཡོད་དེ་། དེ་གང་ཞེ་ན་།
K10mkarmviu:696	 tiryakṣūpapadyate. yamalokāc cyuto yamaloke upapadyate. devebhyaś cyuto deveṣūpapadyate.	K10Dx_H0344:475a-9	གང་ཟག་གང་སེམས་ཅན་དམྱལ་བ་ལས་ཚེ་འཕོས་ཏེ་སེམས་ཅན་དམྱལ་བ་ཉིད་དུ་སྐྱེ་བ་དང་། དུད་འགྲོ་ལས་ཚེ་འཕོས་ཏེ་དུད་འགྲོ་ཉིད་དུ་སྐྱེ་བ་དང་། གཤིན་རྗེའི་འཇིག་རྟེན་ལས་ཚེ་འཕོས་ཏེ་གཤིན་རྗེའི་འཇིག་རྟེན་ཉིད་དུ་སྐྱེ་བ་དང་།
K10mkarmviu:697	 yathā varṣākārasya brāhmaṇasya punaḥ punaḥ kālagatasya markaṭopapattiḥ. yathā kāśmīrāyāṃ  pūrvoktasya gṛhapateḥ punaḥ punaḥ paśūpapattiḥ. yathā ca śrāvastyāṃ kaścid daridraḥ	K10Dx_H0344:475a-10	ལྷ་ལས་ཚེ་འཕོས་ཏེ་ལྷ་ཉིད་དུ་སྐྱེ་བ་དང་། བྲམ་ཟེ་བེ་ཤྱ་ཀ་ར་ཡང་དང་ཡང་ཚེ་འཕོས་ཤིང་སྤྲེའུར་སྐྱེ་བ་དང་། སྔར་སྨོས་པའི་ཁྱིམ་བདག་ཡང་དང་ཡང་ཕྱུགས་སུ་སྐྱེས་པ་བཞིན་ནོ་༎ མཉན་དུ་ཡོད་པ་ན་ཁྱིམ་བདག་དབུལ་པོ་གཅིག་ཚེ་འཕོས་པ་ནས་།
K10mkarmviu:699	 kuṭumbī kālagataḥ. tasya gṛhadvāre balīvardo vraṇībhūtena skandhena tiṣṭhati. sa  gṛha āsaktacittaḥ kuṭumbī tasya balīvardasya skandhe kṛmiḥ pratyājātaḥ. upapannamātraś	K10Dx_H0344:475a-12	དེའི་ཁྱིམ་སྒོ་ན་གླང་སྒལ་བ་ཅན་ཞིག་ཡོད་དོ་༎ ཁྱིམ་བདག་དེ་སེམས་ཁྱིམ་ལ་༄༤༧༥བ་ཆགས་པས་ཚེ་འཕོས་ནས་གླང་དེའི་སྒལ་པའི་སྲིན་བུར་སྐྱེས་ཏེ་། སྐྱེས་མ་ཐག་ཏུ་བྱ་རོག་གིས་ཟོས་པ་དང་། ཡང་དེ་ཉིད་དུ་སྲིན་བུར་སྐྱེས་སོ་༎
K10mkarmviu:702	 kālagataḥ. upapannamātraś ca kākena bhakṣitaḥ. yathā cāryamahāmaudgalyāyano magadheṣu  bhaikṣyaṃ paryaṭamāno 'nyatamagṛhadvāram anuprāptaḥ. tasmiṃś ca gṛhe gṛhapatiḥ patnīsahito	K10Dx_H0344:475b-2	དེ་ལྟར་དེ་ཉིད་དུ་ཉིན་གཅིག་ལ་ལན་བདུན་ཚེ་འཕོས་ཤིང་སྐྱེས་པ་ལྟ་བུ་དང་། འཕགས་པ་མོཨོངགལ་གྱི་བུ་ཆེན་པོ་ཡུལ་མ་ག་དྷར་བསོད་སྙོམས་ལ་སོང་སོང་བ་ལས་ཁྱིམ་ཞིག་གི་སྒོའི་ནང་དུ་ཕྱིན་པ་དང་། ཁྱིམ་དེ་ན་ཁྱིམ་བདག་བུད་མེད་དང་བཅས་པ་ཞིག་པང་ན་བུ་ཐོགས་ཏེ་།
K10mkarmviu:704	 matsyamāṃsaprakāreṇa bhojanaṃ bhuṅkte. putreṇa paryaṅkagatena kṛṣṇā cāsya kukkurī  puraḥ sthitā. sa tasya matsyā sthīni kṣipati. atḥa sa gṛhapatir mahāmaudgalyāyanaṃ	K10Dx_H0344:475b-3	ཉ་ཤའི་བྱན་དང་བཅས་པའི་ཁ་ཟས་ཟ་ཞིང་མདུན་ན་ཁྱི་ནག་པོ་ཞིག་འདུག་པ་དེ་ལ་ཉའི་རུས་པ་འདོར་རོ་༎
K10mkarmviu:706	 dṛṣṭvāha. gamyatām ārya nāsti kāścid atra yo bhikṣāṃ dāsyati. sa khalu saṃprasthitaḥ.	K10Dx_H0344:475b-4	དེ་ནས་ཁྱིམ་བདག་དེས་མོཨོངགལ་གྱི་བུ་ཆེན་པོ་མཐོང་ནས་། འཕགས་པ་འདི་ན་སློང་བ་ལ་སྦྱིན་པ་སུའང་མ་མཆིས་ཀྱི་།
K10mkarmviu:707	 taśmiṃś ca gṛhadvāre deśāntarābhyāgatāḥ puruṣā vidvāṃsaḥ pūrvasthitāḥ te taṃ dṛṣṭvā	K10Dx_H0344:475b-6	སླར་བཞུད་ཅིག་ཅེས་སྨྲས་ཏེ་སླར་ལོག་པ་དང་། ཁྱིམ་དེའི་སྒོ་ན་ཡུལ་གཞན་ནས་འོངས་པའི་སྐྱེས་བུ་མཁས་པ་ཞིག་སྔ་ན་འདུག་འདུག་པ་དེས་། དེས་དེ་མཐོང་ནས་ངོ་མཚར་དུ་གྱུར་ཏེ་།
K10mkarmviu:708	 vismayaṃ prāptāḥ. aho āścaryam ayaṃ nāma ṛddhimatām agryaḥ yena nandopanandau nāgarājānau	K10Dx_H0344:475b-8	ཀྱེ་མ་། བཙུན་པ་འདི་ནི་རྫུ་འཕྲུལ་ཅན་གྱི་མཆོག་སྟེ་། ཀླུའི་རྒྱལ་པོ་དགའ་པོ་དང་། ཉེར་དགའ་བོ་ནི་བཏུལ་།
K10mkarmviu:709	 vinītau vaijayantaś ca prāsādo vāmapādāṅguṣṭhena kampitaḥ śakro vismāpitaḥ trisāhasraṃ	K10Dx_H0344:475b-10	ལྷའི་ཕོ་བྲང་རྣམ་པར་རྒྱལ་བའང་ཕྱག་ག-ཡོན་པའི་མཐེ་བོས་བསྒུལ་ཏེ་བརྒྱ་བྱིན་ཡང་ངོ་མཚར་དུ་གྱུར་། སྟོང་གསུམ་གྱི་སྟོང་ཆེན་པོའི་འཇིག་རྟེན་གྱི་ཁམས་ཀྱང་མིག་བཙུམས་པ་ཙམ་གྱིས་བསྐོར་བ་ལགས་ན་།
K10mkarmviu:710	 lokadhātuṃ nimeṣāntaracārī sa nāma bhikṣām adattvā visarjitaḥ. atha sthaviras teṣāṃ	K10Dx_H0344:476a-0	བསོད་སྙོམས་མ་གསོལ་བར་སླར་༄༤༧༦ཨ་༌༎ བཏང་བ་ནི་ངོ་མཚར་ཆེའོ་ཞེས་བྱ་བ་དང་། དེ་ནས་གནས་བརྟན་གྱིས་དེ་དག་སྐྱོ་བར་བྱ་བའི་ཕྱིར་སྨྲས་པ་།
K10mkarmviu:711	 saṃvejanārtham āha. vatsa. naitad āścaryam. puruṣā ūcuḥ. atha kim anyad āścaryaṃ	K10Dx_H0344:476a-2	ཁྱེའུ་ངོ་མཚར་མི་ཆེའོ་༎ མི་དེས་སྨྲས་པ༏་འོ་ན་ངོ་མཚར་ཆེན་པོ་ཅི་མཆིས་། ངེས་སྨྲས་པ་།
K10mkarmviu:712	 vismayakāraṇam. sa uvāca. ya eṣa gṛhapatir matsyamāṃsaprakārair bhojanaṃ (MKV 73)	K10Dx_H0344:476a-5	འདི་ན་ཁྱིམ་བདག་ཉ་ཤའི་བྱན་དང་བཅས་པའི་ཁ་ཟས་ཟ་བ་དེ་།
K10mkarmviu:713	 bhuṅkte eṣa matsyaḥ asya gṛhapateḥ pitā. tena yā eṣāsya gṛhasya pṛṣṭhataḥ puṣkariṇī	K10Dx_H0344:476a-6	ཉ་དེ་ནི་ཁྱིམ་བདག་དེའི་ཕ་ཡིན་ཏེ་།
K10mkarmviu:714	 ataḥ prabhūtamatsyān uddhṛtyoddhṛtya bhakṣitāḥ. sa kālagato 'traiva matsyaḥ pratyājātaḥ.	K10Dx_H0344:476a-7	འདི་ནི་ཁྱིམ་གྱི་རྒྱབ་ན་རྫིང་ཉ་མང་པོ་ཞིག་ཡོད་པ་ནས་ཉ་རྣམས་བཅུས་ཤིང་བཅུས་ཤིང་ཟོས་ཏེ་། མི་དེ་ཚེ་འཕོས་པ་དང་ཉ་དེ་དག་ཉིད་ཀྱི་ནང་དུ་སྐྱེས་སོ་༎
K10mkarmviu:715	 sa eṣo 'nekaśa uddhṛtyoddhṛtya bhakṣyate. atraiva ca bhūyo bhūya upapadyate. yāpy	K10Dx_H0344:476a-9	དེའི་བུ་འདིས་ཀྱང་ལན་བརྒྱ་ཕྲག་དུ་མར་ཉ་དེ་བཅུས་ཤིང་བཅུས་ཤིང་ཟོས་ཏེ་། འདི་ཉིད་དུ་ཡང་དང་། ཡང་དུ་ལན་དུ་མར་སྐྱེས་སོ་༎
K10mkarmviu:716	 eṣā kukkurī asyaiva gṛhapater mātā. etayā lobhadoṣeṇa na kiṃcid dānaṃ dattam. na	K10Dx_H0344:476a-11	ཁྱི་མོ་འདི་ནི་ཁྱིམ་བདག་དེའི་མ་ཡིན་ཏེ་། འདི་ཡང་ཆགས་པའི་ཟིལ་གྱིས་ནོན་པས་སུ་ལ་ཡང་སྦྱིན་པའང་མ་བྱིན་།
K10mkarmviu:717	 ca śīlaṃ sevitam. kevalaṃ kulavaṃśārthaṃ dravyaṃ paripālitam. sātraiva gṛhe āsaktacittā	K10Dx_H0344:476a-13	ཚུལ་ཁྲིམས་ཀྱང་མ་བསྲུངས་པར་གྱི་ནར་རིགས་དང་རྒྱུད་ཀྱི་དོན་དུ་རྫས་རྣམས་བསྲུངས་ཏེ་།
K10mkarmviu:718	 kālagatā kukkurīṣu pratyājātā. kālagatā bhūyo bhūyo 'traivopapadyate. sarvāṃ ca rātrīṃ  gṛhaṃ samantāt paryaṭati. mātra kaścit praviśed iti. atha yas tv eṣa putraḥ paryaṅke	K10Dx_H0344:476a-14	དེའང་ཁྱིམ་འདི་ཉིད་ལ་སེམས་ཆགས་བཞིན་དུ་ཚེ་འཕོས་ནས་ཁྱི་མོ་དེར་སྐྱེས་ཏེ་། དེ་ནས་ཚེ་འཕོས་ནས་ཀྱང་ཡང་དང་། ཡང་དུ་འདི་ཉིད་དུ་སྐྱེས་ཏེ་། ཁྱིམ་འདིར་མི་གཞན་ཞུགས་སུ་དོགས་ནས་མཚན་ཐོག་ཐག་ཀྱང་ཁྱིམ་ཕྱི་སྐོར་རོ་༎ མི་དེའི་སྤང་ན་འདུག་པའི་བུ་དེ་ཡང་དེའི་ཆུང་མའི་བྱི་བོ་ཡིན་ཏེ་།
K10mkarmviu:720	 kṛtaḥ eṣo 'syā eva striyāḥ pracchannabhartā anena ca gṛhapatinā śrutam. eṣā te patnī	K10Dx_H0344:476b-0	ཁྱིམ་བདག་འདིས་ཆུང་མ་མི་གཞན་དང་ཉལ་བར་༄༤༧༦བ་ཐོས་ནས་།
K10mkarmviu:721	 parapuruṣavyāsaktā jāteti. sa eṣa gṛhapatir grāmāntara gamanavyapadeśena gṛhān niṣkrāntaḥ.  eṣāpi strī parapuruṣeṇa saha śayitā. anena gṛhapatinā rātrāv āgamya puruṣo ghātitaḥ.	K10Dx_H0344:476b-1	ཁྱིམ་བདག་དེ་གྲོང་གཞན་དུ་འགྲོ་བ་ལྟར་བྱས་ཏེ་ཁྱིམ་ནས་ཕྱིར་བྱུང་བ་དང་། བུད་མེད་དེའང་མི་གཞན་དང་ཉལ་བ་ལ་ཁྱིམ་བདག་འདི་སླར་ལྡོག་སྟེ་མི་དེ་བསད་དོ་༎
K10mkarmviu:723	 so 'syām eva striyām āraktacittas tenaiva snehānubandhena kukṣav upapannaḥ. paśya	K10Dx_H0344:476b-2	དེ་ཡང་བུད་མེད་དེ་ལ་ཆགས་ཤིང་སྡུག་པའི་རྒྱུས་བུད་མེད་འདིའི་རུམ་དུ་སྐྱེས་སོ་༎
K10mkarmviu:724	 vatsa yaḥ pitā caiva tasya sa maṃsāni bhakṣayati. yā mātā janitrī tasyā matsyakaṇtakāsthikāni	K10Dx_H0344:476b-3	ཁྱེའུ་ལྟོས་། ཕ་གང་ཡིན་པ་དེའི་ཤ་ནི་ཟ་། མ་གང་ཡིན་པ་དེ་ལ་ནི་ཉའི་རུས་པ་དང་གྲ་མ་འདོར་།
K10mkarmviu:725	 dadāti. yaś ca śatruḥ kruddhena māritaḥ pāradārikaḥ taṃ paryaṅkena dhārayati. eṣa  saṃsāradoṣo nirvedaḥ kāryaḥ. idam atrāścaryakāraṇam. atha sa bhikṣur mahāmaudgalyāyana	K10Dx_H0344:476b-5	བྱི་བོ་བྱེད་བྱེད་པའི་དགྲ་བོ་ཁྲོས་པས་བསད་པ་གང་ཡིན་པ་དེ་ནི་པང་དུ་བླངས་སོ་༎
K10mkarmviu:754	 śrotaāpannasya. sakṛdāgāminaḥ. anāgāminaḥ. pratyekabuddhasya. ayaṃ pudgalo yasya	K10Dx_H0344:477a-5	དེ་གང་ཞེ་ན་། རྒྱུན་དུ་ཞུགས་པ་དང་། ལན་གཅིག་ཕྱིར་འོང་བ་དང་། ཕྱིར་མི་འོང་བ་དང་། དགྲ་བཅོམ་པ་ལྟ་བུ་སྟེ་།
K10mkarmviu:755	 nāyuḥ kṣīṇaṃ [na] karma. api tu kleśāḥ kṣīṇāḥ.	K10Dx_H0344:477a-7	གང་ཟག་དེ་ནི་ཚེ་ཡང་མ་ཟད་ཅིང་ལས་ཀྱང་མ་ཟད་ལ་དེའི་ཉོན་མོངས་པ་ཟད་པ་ཡིན་ནོ་༎
K10mkarmviu:756	 XLIV. katamaḥ pudgalaḥ kāyena sukhī na cittena. ucyate. kṛtapuṇyaḥ pṛthagjanaḥ kāyena	K10Dx_H0344:477a-8	དེ་ལ་གང་ཟག་ལུས་བདེ་ལ་སེམས་མི་བདེ་བ་ཡོད་དེ་། དེ་གང་ཞེ་ན་། སོ་སོའི་སྐྱེ་བོ་ཕལ་པ་བསོད་ནམས་བྱས་པ་ནི་ལུས་བདེ་ལ་སེམས་མི་བདེ་སྟེ་།
K10mkarmviu:757	 sukhī na cittena. yathā mahādhanabrāhmaṇagṛhapatayo rājā ca māndhātā. ayaṃ pudgalaḥ	K10Dx_H0344:477a-11	དཔེར་ན་། ཡུལ་མ་ག་དྷའི་བྲམ་ཟེ་དང་། ཁྱིམ་བདག་དང་། རྒྱལ་པོ་མན་ཏ་ལ་སོགས་པ་ལྟ་བུ་སྟེ་།
K10mkarmviu:758	 kāyena sukhī na cittena.	K10Dx_H0344:477a-12	གང་ཟག་འདི་ནི་ལུས་བདེ་ལ་སེམས་མི་བདེ་བའོ་༎
K10mkarmviu:759	 XLV. katamaḥ pudgalaś cittena sukhī na kāyena. ucyate. yathārhann apuṇyaḥ cittena	K10Dx_H0344:477a-13	དེ་ལ་གང་ཟག་ལ་ལ་སེམས་བདེ་ལ་ལུས་མི་བདེ་བ་ཡོད་དེ་། དེ་གང་ཞེ་ན་། དཔེར་ན་དགྲ་བཅོམ་པ་ཀ་ར་མ་ཤ་ལྟ་བུ་ནི་། སེམས་བདེ་ལ་ལུས་མི་བདེ་བ་ཡིན་ནོ་༎
K10mkarmviu:760	 sukhī na kāyena. yathārya śoṇottaras tena kila pūrvajanmani pratyekabuddhasya snāyato  gomayapiṇḍakaḥ kapikacchumiśraḥ snānārthaṃ dattaḥ. tena karma vipākena kuṣṭhena śarīraṃ  viśīryati. tathā hi gāthā bhāṣitā.	K10Dx_H0344:477a-17	འདི་ལྟ་སྟེ་། འཕགས་པ་ཤོ་ནོ་ཏ་རས་ཚེ་རབས་སྔ་མ་ལ་རང་སངས་རྒྱས་ཁྲུས་བྱེད་པ་ལ་བ་ལང་གི་ལྕི་བ་དང་། ཀ་པི་ཏ་སུ་ཀ་ར་བསྲེགས་ཏེ་བཀྲུ་༄༤༧༧བ་བའི་ཕྱིར་བྱིན་པས་དེའི་ལས་ཀྱི་རྣམ་པར་སྨིན་པས་ལུས་མཛེས་གང་བར་མཐོང་ངོ་༎ འདི་ལྟར་ཚིགས་སུ་བཅད་པས་སྨྲས་པ་།
K10mkarmviu:764	 karmāṇi nūnaṃ balavattarāṇi karmabhyo vajrakalpebhyaḥ	K10Dx_H0344:477b-2	ལས་ནི་ཤིན་ཏུ་སྟོབས་ཆེ་སྟེ་༎ རྡོ་རྗེ་ལྟ་བུའི་ལས་རྣམས་ལས་༎
K10mkarmviu:765	 yatra vaśībhūto 'ham anubhavāmi duḥkhāni karmāṇi.	K10Dx_H0344:477b-4	གང་ལ་བདག་གི་དབང་བྱས་ཀྱང་༎ སྡུག་བསྔལ་བ་ཡི་ལས་རྣམས་མྱོང་༎
K10mkarmviu:767	 dāśyāmīti. sa tasya mahatā pariśrameṇa kālātikramaṇe āsanne bhaktaṃ dattavān. sa	K10Dx_H0344:477b-8	ཟན་སྤྱད་དེ་སྦྱིན་ནོ་སྙམ་ནས་དེ་ལ་རིངས་ཤིག་ལོན་ཏེ་དུས་ཡོལ་བར་ཟས་བྱིན་ནོ་༎
K10mkarmviu:768	 tena karmaṇā paścime janmani vītarāgo 'pi bhūtvā pūrvāhṇe piṇḍapātaṃ paryaṭati. kālātikramaṇe	K10Dx_H0344:477b-9	དེ་ཡང་ལས་དེས་ཚེ་ཕྱི་མ་ལ་འཕགས་པར་གྱུར་ཀྱང་སྔ་དྲོ་བསོད་སྙོམས་བསླངས་ན་།
K10mkarmviu:769	 āsanne kathaṃcid bhaktaṃ labhate. tathāsya jaṅghākāśyapa eva nāma. ayaṃ pudgalaś  cittena sukhī na kāyena.	K10Dx_H0344:477b-10	དུས་ཡོལ་ལ་ཐུག་པ་ན་ཟན་རྙེད་པ་ལྟ་བུ་སྟེ་། གང་ཟག་དེ་ལྟ་བུ་ནི་སེམས་བདེ་ལ་ལུས་མི་བདེ་བའོ་༎ གང་ཟག་ལ་ལ་ལུས་ཀྱང་བདེ་ལ་སེམས་ཀྱང་བདེ་བ་ཡོད་དེ་།
K10mkarmviu:771	 XLVI. katamaḥ pudgalaḥ kāyena sukhī cittena ca. ucyate. arhan kṣīṇāsravaḥ kṛtapuṇyaḥ.	K10Dx_H0344:477b-13	དེ་གང་ཞེ་ན་། འདི་ལ་དགྲ་བཅོམ་པ་ཟག་པ་ཟད་པ་བསོད་ནམས་བྱས་པ་ཡིན་ཏེ་། འདི་ལྟ་སྟེ་།
K10mkarmviu:772	 yathā kaśmīrarājā dharmayaśaḥputro bakulaḥ. tathā hy asya siṃhanādaḥ. aśītir me āyuṣmanto	K10Dx_H0344:477b-16	དཔེར་ན་། རྒྱལ་པོ་ཆོས་གྲགས་ཀྱི་བུ་ལུ་ཀུ་བ་ལྟ་བུ་སེངགེའི་སྒྲ་སྒྲོག་ན་།
K10mkarmviu:773	 varṣāṇi pravrajitasya na kadācid vyādhir bhūtapūrvaḥ. antataḥ śiro'rtimātram api.	K10Dx_H0344:477b-17	དེ་ནི་རབ་ཏུ་བྱུང་ནས་ལོ་བརྒྱད་ཅུ་ལོན་ཏེ་། ནམ་ཡང་ཆུང་དུ་ན་ཀླད་པ་ན་བ་ཙམ་ཡང་མ་མྱོང་ངོ་ཞེས་ཟེར་བ་ལྟ་བུ་སྟེ་།
K10mkarmviu:774	 tena kila vārāṇasyāṃ gāndhikabaṇijā bhūtvā kakucchandaḥ samyaksaṃbuddhaḥ saśrāvakasaṃgho	K10Dx_H0344:477b-19	དེའང་སྔོན་ཡུལ་ཝའ་ར་ནའ་སིར་སྤོས་འཚོང་ཞིག་ཏུ་གྱུར་པ་ན་།
K10mkarmviu:775	 glānabhaiṣajyenopanimantrito bhikṣuṇā cārhatā ekā harītakī gṛhītā. sa tasya karmaṇo	K10Dx_H0344:478a-0	སངས་རྒྱས་ལོག་པར་དད་སེལ་ཉན་ཐོས་ཀྱི་དགེ་འདུན་དང་བཅས་པ་ལན་བའི་གསོས་སྨན་ཕུལ་བ་དང་། དགྲ་བཅོམ་པ་ལ་ཨཨ་༄༤༧༨ཨ་༌༎
K10mkarmviu:776	 vipākena nirābādhaḥ. ārogyaparamā lābhā uktā bhagavatā. yathā cāryāniruddhaḥ kathayati.  tasya khalv āyuṣmantaḥ piṇḍapātasya vipākena saptakṛtvaḥ praṇīte trayastriṃśadevanikāye  upapannaḥ saptakṛtvo manuṣyeṣu rājyaṃ kāritam. tasyaiva ca piṇḍapātasya (MKV 77)  vipākenārhatvaphalalābhī cīvarapiṇḍapātaśayanāsanaglānapratyayabhaiṣajyapariṣkārāṇāṃ  lābhī. tathā hi tasya bhagavatā durbhikṣe pañca bhikṣuśatāni dattāni. tasya puṇyānubhāvena	K10Dx_H0344:478a-1	རུ་ར་ཕུལ་བའི་ལས་ཀྱི་རྣམ་པར་སྨིན་པ་དེས་ནད་མེད་ཅིང་བདེ་བའི་མཆོག་ཐོབ་བོ་ཞེས་གསུངས་པ་ལྟ་བུ་སྟེ་།
K10mkarmviu:781	 sarveṣāṃ divyam anantabhaktaṃ prādurbhavati. ayaṃ pudgalaḥ kāyena sukhī cittena ca.	K10Dx_H0344:478a-2	གང་ཟག་དེ་ནི་ལུས་ཀྱང་བདེ་ལ་སེམས་ཀྱང་བདེ་བའོ་༎
K10mkarmviu:782	 XLVII. katamaḥ pudgalo na kāyena sukhī na cittena ca. akṛtapuṇyāḥ pṛthagjanā utsannakulavaṃśā	K10Dx_H0344:478a-3	ལས་གང་དང་ལྡན་ན་། གང་ཟག་ལུས་ཀྱང་མི་བདེ་ལ་སེམས་ཀྱང་མི་བདེ་བ་ཡོད་དེ་།
K10mkarmviu:783	 vastrānnapānavirahitāḥ paragṛheṣu hiṇḍanti. tathā vyādhibhiḥ kuṣṭhakṣayakāsajvarapāṇḍurogadadrupāmādibhiḥ	K10Dx_H0344:478a-5	དེ་གང་ཞེ་ན་། འདི་ལ་སོ་སོའི་སྐྱེ་བོ་བསོད་ནམས་མ་བྱས་པ་དག་རིགས་དང་། རྒྱུད་ཀྱི་གོས་དང་། ཟས་སྐོམ་དང་བྲལ་བ་གཞན་གྱི་ཁྱིམ་རྒྱུ་བ་དག་ཡོད་དེ་། འདི་ལྟ་སྟེ་།
K10mkarmviu:784	 parigatā hastapādavikalāś cakṣurvihīnāś ca. ayaṃ pudgalo na kāyena sukhī na cittena.	K10Dx_H0344:478a-8	ནད་མཛེ་དང་། ལུང་པ་དང་། རིམས་དང་། ཤུ་བ་དང་། ག-ཡན་པ་ལ་སོགས་པའི་ནད་རྣམས་ཀྱིས་ཡོངས་སུ་གཟིར་ཅིང་རྐང་ལག་མེད་པ་མིག་དང་བྲལ་བ་དག་ཡོད་དེ་། གང་ཟག་འདི་ནི་ལུས་ཀྱང་མི་བདེ་ལ་སེམས་ཀྱང་མི་བདེ་བ་ཡིན་ནོ་༎
K10mkarmviu:785	 XLVIII. katamat karma yena samanvāgataḥ pudgalo 'pāyeṣūpapanno 'bhirūpo bhavati prāsādikaḥ	K10Dx_H0344:478a-10	དེ་ལ་གང་ཟག་ལས་གང་དང་ལྡན་ན་ངན་སོང་རྣམས་སུ་སྐྱེས་ཀྱང་གཟུགས་བཟང་ཞིང་མཛེས་ལ་ལུས་སྣུམ་ཞིང་མདོག་འཚེར་ལ་མིག་ཏུ་སྡུག་ཅིང་བལྟ་ན་དགའ་བར་འགྱུར་བའི་ལས་ཡོད་དེ་། དེ་གང་ཞེ་ན་།
K10mkarmviu:786	 snigdhakāyaḥ snigdhacchavir nayanābhirāmo darśanīyaḥ. ucyate. yaḥ pudgalo rāgasamutthitena  dauḥśīlyena samanvāgataḥ apāyeṣūpapadyate. yathā mayūraśukasārikākāraṇḍavacakravākaprabhṛtayaḥ.	K10Dx_H0344:478a-12	གང་ཟག་གང་འདོད་ཆགས་ལས་བྱུང་བའི་ངང་ཚུལ་ངན་པ་དང་ལྡན་པ་དེ་ནི་ངན་སོང་རྣམས་སུ་སྐྱེ་སྟེ་། དཔེར་ན་། རྨ་བྱ་དང་། ནེ་ཙོ་དང་། བྱ་ཤ་རི་ཀ་དང་། ཕྱ་ཀའ་ར་ན་ད་པ་དང་། ངུར་བ་ལ་སོགས་པ་ལྟ་བུ་སྟེ་།
K10mkarmviu:788	 idaṃ karma yena samanvāgataḥ pudgalo 'pāyeṣūpapanno 'bhirūpo bhavati prāsādikaḥ snigdhakāyaḥ  snigdhacchavir nayanābhirāmo darśanīyaḥ.	K10Dx_H0344:478a-14	འདི་ནི་གང་ཟག་ལས་གང་དང་ལྡན་ན་། ངན་སོང་རྣམས་སུ་སྐྱེས་ཀྱང་གཟུགས་༄༤༧༨བ་བཟང་ཞིང་མཛེས་ལ་ལུས་སྣུམ་ཞིང་མདོག་འཚེར་བ་མིག་ཏུ་སྡུག་ཅིང་བལྟ་ན་དགའ་བར་འགྱུར་བའོ་༎
K10mkarmviu:790	 XLIX. tatra katamat karma yena samanvāgataḥ pudgalo 'pāyeṣūpapanno durvarṇo bhavati	K10Dx_H0344:478b-1	དེ་ལ་གང་ཟག་ལས་གང་དང་ལྡན་ན་། ངན་སོང་དུ་སྐྱེས་ལ་མདོག་མི་བཟང་ཞིང་ལུས་རྩུབ་པ་བལྟ་ན་མི་སྡུག་པར་འགྱུར་བའི་ལས་ཡོད་དེ་། དེ་གང་ཞེ་ན་།
K10mkarmviu:791	 rūkṣakāyo ghoradarśanaḥ. ucyate. yaḥ pudgalo dveṣasamutthitena dauḥśīlyena samanvāgato	K10Dx_H0344:478b-4	གང་ཟག་དེ་ནི་ཞེ་སྡང་ལས་བྱུང་བའི་ངང་ཚུལ་ངན་པ་དང་ལྡན་པས་ངན་སོང་རྣམས་སུ་སྐྱེས་པ་སྟེ་།
K10mkarmviu:792	 'pāyeṣūpapadyate. yathā siṃhavyāghrakākaśṛgālakṛṣṇasarpapretapiśācādayaḥ. idaṃ karma  yena apāyeṣūpapanno durvarṇo bhavati rūkṣakāyo ghoradarśanaḥ.	K10Dx_H0344:478b-6	སེངགེ་དང་། སྟག་དང་། བྱ་རོག་དང་། ཝ་དང་། དྲེད་མོ་དང་། སྦྲུལ་ནག་པོ་དང་། ཡི་དབ༹གས་དང་། ཤ་ཟ་ལ་སོགས་པ་ལྟ་བུའོ་༎ འདི་ནི་གང་ཟག་ལས་གང་དང་ལྡན་ན་། ངན་སོང་རྣམས་སུ་སྐྱེས་ནས་མདོག་མི་བཟང་ཞིང་ལུས་རྩུབ་ལ་བལྟ་ན་མི་སྡུག་བའི་ལས་ཡིན་ནོ་༎
K10mkarmviu:794	 L. tatra katamat karma yena samanvāgataḥ pudgalo 'pāyeṣūpapanno durgandho bhavati	K10Dx_H0344:478b-9	གང་ཟག་ལས་གང་དང་ལྡན་ན་། ངན་སོང་རྣམས་སུ་སྐྱེས་ནས་ལྕེའི་དབང་པོ་དྲི་ང་བར་འགྱུར་བ་ཡོད་དེ་། དེ་གང་ཞེ་ན་།
K10mkarmviu:795	 jihmendriyo 'vyaktendriyaḥ. ucyate. yaḥ pudgalo mohasamutthitena dauḥśīlyena samanvāgataḥ	K10Dx_H0344:478b-12	གང་ཟག་དེ་ནི་གཏི་མུག་ལས་བྱུང་བའི་ངང་ཚུལ་ངན་པ་དང་ལྡན་པས་ངན་སོང་རྣམས་སུ་སྐྱེས་པ་སྟེ༏་འདི་ལྟ་སྟེ་།
K10mkarmviu:797	 yathā chuchundarīkṛmyajagarayūkāmakṣikādayo yathā śarīre viṃśatikṛmijātayaḥ. idaṃ karma yena samanvāgataḥ pudgalo 'pāyeṣūpapanno durgandho bhavati jihmendriyo 'vyaktendriyaḥ.	K10Dx_H0344:478b-13	སྲོག་ཆགས་ཚུ་ཚུན་ད་རི་དང་། སྲིན་བུ་དང་། སྦྲུལ་དང་། ཤིག་དང་། སྦྲང་མ་དང་། མང་ཀུན་ལ་སོགས་པ་དང་། ལུས་ལ་སྲིན་བུའི་རིགས་ཉི་ཤུ་ཡོད་པ་ལྟ་བུ་སྟེ་། འདི་ནི་གང་ཟག་ལས་གང་དང་ལྡན་ན་། ངན་སོང་རྣམས་སུ་སྐྱེས་ནས་ལྕེའི་དབང་པོ་དྲི་ང་ཞིང་དབང་པོ་མི་གསལ་བར་འགྱུར་བའི་ལས་སོ་༎
K10mkarmviu:798	 LI. daśākuśalāḥ karmapathāḥ. katame daśa. trividhaṃ kāyakarma. caturvidhaṃ vākkarma.	K10Dx_H0344:479a-0	མི་༄༤༧༩ཨ་༌༎ དགེ་བའི་ལས་ཀྱི་ལམ་བཅུ་སྟེ་། བཅུ་གང་ཞེ་ན་། ལུས་ཀྱི་ལས་རྣམ་གསུམ་དང་། ངག་གི་ལས་རྣམ་བཞི་དང་། ཡིད་ཀྱི་ལས་རྣམ་གསུམ་སྟེ་།
K10mkarmviu:799	 trividhaṃ manaskarma. eṣāṃ daśānām akuśalānāṃ karmapathānāṃ vipākena daśānāṃ bāhyānāṃ  bhāvānām abhivṛddhir bhavati.	K10Dx_H0344:479a-3	མི་དགེ་བའི་ལས་ཀྱི་ལམ་བཅུ་པོ་འདི་དག་གི་རྣམ་པར་སྨིན་པས་ཕྱི་རོལ་གྱི་དངོས་པོ་བཅུ་རྒུད་པར་འགྱུར་ཏེ་།
K10mkarmviu:801	 LII. prāṇātipātasyākuśalakarmapathasya vipākena pṛthivyā ojaś ca tejaś cāntardhīyate. tasyaiva ca karmaṇo vipākenālpāyur bhavati.	K10Dx_H0344:479a-4	སྲོག་གཅོད་པ་མི་དགེ་བའི་ལས་ཀྱི་རྣམ་པར་སྨིན་པས་སའི་མདངས་དང་གཟི་བྱིན་ནུབ་པར་འགྱུར་རོ་༎ ལས་དེ་ཉིད་ཀྱི་རྣམ་པར་སྨིན་པས་ཚེ་ཐུང་བར་འགྱུར་རོ་༎
K10mkarmviu:802	 LIII. adattādānasyākuśalasya karmapathasya vipākena pṛthivyām aśaniśukaśalabhamūṣikakīṭaprabhṛtayaḥ sasyaghāsakā utpadyante. tasyaiva karmaṇo vipākena bhogavyasanam adhigacchati.  LIV. kāmamithyācārasyākuśalasya karmapathasya vipākena pṛthivyāṃ tṛṇadarbhādīni durgandhīni	K10Dx_H0344:479a-6	མ་བྱིན་པར་ལེན་པ་མི་དགེ་བའི་ལས་ཀྱི་རྣམ་པར་སྨིན་པས་། ས་ལ་སེར་བ་དང་། བྱ་དང་། བ་ལང་དང་། བྱི་བ་དང་། སྲིན་བུ་ལ་སོགས་པ་ལོ་ཐོག་ལ་ཟ་བ་རྣམས་འབྱུང་ངོ་༎ ལས་དེ་ཉིད་ཀྱི་རྣམ་པར་སྨིན་པ་ལས་ལོངས་སྤྱོད་འཁྱམ་པར་འགྱུར་རོ་༎ འདོད་པ་ལ་ལོག་པར་ག-ཡེམ་པ་མི་དགེ་བའི་ལས་ཀྱི་རྣམ་པར་སྨིན་པས་། ས་ལ་རཙབ༹་དྲི་ང་བ་དང་། ནགས་ཚལ་དྲི་ང་བ་དག་སྐྱེ་བར་འགྱུར་རོ༏་༏ལས་དེ་ཉིད་ཀྱི་རྣམ་པར་སྨིན་པས་ལོ་ལེགས་པའི་ཁྱིམ་ན་གནས་པའི་རྟོགས་པ་བརྗོད་པ་།
K10mkarmviu:806	 LV. mṛṣāvādasyākuśalasya karmapathasya vipākena mukharogadantarogagalarogamukhadaurgandhyādīni (MKV 79)  prādurbhavanti. tasyaiva karmaṇo vipākenābhūtākhyānaṃ pratilabhate.	K10Dx_H0344:479a-12	ནག་པོ་འཆར་ལྡན་གྱིས་ཚེ་རབས་སྔ་མའི་རྟོགས་པ་བརྗོད་པ་སྨོས་པ་རྣམས་བྱའོ་༎ རྫུན་སྨྲ་བའི་མི་དགེ་བའི་ལས་ཀྱི་རྣམ་པར་སྨིན་པ་ལ་ཁ་ན་བ་དང་། ལྐོག་མ་ན་བ་དང་། ཁ་མནམ་པ་ལ་༄༤༧༩བ་སོགས་པར་འགྱུར་རོ་༎ ལས་དེ་ཉིད་ཀྱི་རྣམ་པར་སྨིན་པས་། མི་བདེན་པས་བསླུས་པར་འགྱུར་བའོ་༎
K10mkarmviu:808	 LVI. piśunavacanasyākuśalasya karmapathasya vipākena pṛthivyāṃ śarkarakaṭhallyādīni  duḥkhasaṃsparśādīni prādurbhavanti. tasyaiva karmaṇo vipākena jātivyasanā mitravyasanā  bhavanti bhedyaḥ parivāraś ca bhavati.	K10Dx_H0344:479b-3	ཕྲ་མ་ཟེར་བའི་མི་དགེ་བའི་ལས་ཀྱི་རྣམ་པར་སྨིན་པས་ས་ལ་གསེག་མ་དང་། གྱོ་མོ་ལ་སོགས་པ་རེག་ན་མི་བདེ་བ་རྣམས་འབྱུང་ངོ་༎ ལས་དེ་ཉིད་ཀྱི་རྣམ་པར་སྨིན་པས་ག-ཡོག་འཁོར་དབྱེར་རུང་བར་འགྱུར་རོ་༎
K10mkarmviu:811	 LVIl. paruṣavacaso 'kuśalakarmapathasya vipākena pāṃśurajodhūlivātavṛṣṭyādīni prādurbhavanti. tasyaiva karmaṇo vipākenāmanojñaśabdaśravaṇadarśanāny	K10Dx_H0344:479b-5	ཚིག་རྩུབ་པོ་མི་དགེ་བའི་ལས་ཀྱི་རྣམ་པར་སྨིན་པས་ས་ལ་རྡུལ་དང་། ཉལ་ཉིལ་གྱི་རླུང་ལྡང་ཞིང་ཆར་ཆེན་པོ་ལ་སོགས་པ་འབབ་བོ་༎ ལས་དེ་ཉིད་ཀྱི་རྣམ་པར་སྨིན་པས་ཡིད་དུ་མི་འོང་བའི་སྒྲ་ཐོས་པ་དང་། ཡིད་དུ་མི་འོང་བ་མཐོང་བར་འགྱུར་རོ་༎
K10mkarmviu:812	 LVIII. saṃbhinnapralāpasyākuśalasya karmapathasya vipākena ... kandaraśvabhrādīni prādurbhavanti. tasyaiva karmaṇo vipākenānādeyavacanā bhavanti.  LIX. abhidhyāyā akuśalasya karmapathasya vipākena vrīhiyavagodhūmādīnāṃ sasyānāṃ tuṣapalālādīni prādurbhavanti. tasyaiva karmaṇo vipākena paraprārthanīyabhogā	K10Dx_H0344:479b-7	ཚིག་ཀྱལ་བར་སྨྲ་བ་མི་དགེ་བའི་ལས་ཀྱི་རྣམ་པར་སྨིན་པས་ས་མཐོ་དམན་དང་། སྨན་ལྗོངས་དང་། ངམ་གྲོག་དང་། ག-ཡང་ས་ལ་སོགས་པ་འབྱུང་ངོ་༎ ལས་དེ་ཉིད་ཀྱི་རྣམ་པར་སྨིན་པས་ཚིག་མི་བཙུན་པར་འགྱུར་རོ་༎ ཆགས་སེམས་མི་དགེ་བའི་ལས་ཀྱི་རྣམ་པར་སྨིན་པས་འབྲས་དང་། ནས་དང་། གྲོ་ལ་སོགས་པའི་འབྲས་བུ་ཉུང་ཞིང་གྲ་མ་དང་། སྦུན་པ་ལ་སོགས་པའི་སྐྱོན་མང་བར་འགྱུར་རོ་༎ ལས་དེ་ཉིད་ཀྱི་རྣམ་པར་སྨིན་པས་ལོངས་སྤྱོད་གཞན་གྱིས་ཁྱེར་བར་འགྱུར་རོ་༎
K10mkarmviu:814	 LX. vyāpādasyākuśalakarmapathasya vipākena prabhūte upte niṣphalaṃ sasyaṃ bhavati. tasyaiva karmaṇo vipākena pratikūladarśano bhavati.  LXI. mithyādṛṣṭer akuśalasya karmapathasya vipākena tiktakaṭukabhāvāny (MKV 80)  api picumandakoṣātakīviṣatiktālābuprabhṛtīni phalāni prādurbhavanti. mithyādṛṣṭer  akuśalasya karmapathasya vipākena nāstikyavādī bhavati. ucchedadṛṣṭiḥ lokāyatādiṣu	K10Dx_H0344:479b-11	གནོད་སེམས་མི་དགེ་བའི་ལས་ཀྱི་རྣམ་པར་སྨིན་པས་ལོ་ཏོག་དང་། འབྲས་བུ་དང་། ས་བོན་ཚ་བ་དང་། ཁ་བ་འབྱུང་བར་འགྱུར་རོ་༎
