src_segmentnr	src_original	tgt_segmentnr	tgt_original
K10sukhvysu:51	 ratnasya / tāsu ca puṣkariṇīṣu saṃti padmāni jātāni nīlāni	TZ21-ZHA-021:407	རྫིང་བུ་དེ་དག་ལ་ཀུན་ནས་པདྨ་སྐྱེས་པ་འདི་ལྟ་སྟེ་༔
K10sukhvysu:52	 nīlavarṇāni nīlanirbhāsāni nīlanidarśanāni / pītāni	TZ21-ZHA-021:408	གསེར་དང་༔་གསེར་གྱི་ཁ་དོག་དང་༔་གསེར་གྱི་འོད་འབྱུང་བ་དང་༔་གསེར་ལྟ་བུར་སྟོན་པ་དང་༔་སྔོན་པོ་དང་༔་ཁ་དོག་སྔོན་པོ་༔་འོད་སྔོན་པོར་འབྱུང་བ་༔
K10sukhvysu:53	 pītavarṇāni pītanirbhāsāni pītanidarśanāni / lohitāni	TZ21-ZHA-021:411	སེར་པོ་༔་ཁ་དོག་སེར་པོ་༔་འོད་སེར་པོ་འབྱུང་བ་༔
K10sukhvysu:54	 lohitavarṇāni lohitanirbhāsāni lohitanidarśanāni / avadātāny	TZ21-ZHA-021:414	དམར་པོ་༔་ཁ་དོག་དམར་པོ་༔་འོད་དམར་པོ་འབྱུང་བ་༔
K10sukhvysu:55	 avadātavarṇāny avadātanirbhāsāny avadātanidarśanāni / citrāni	TZ21-ZHA-021:417	དཀར་པོ་༔་ཁ་དོག་དཀར་པོ་༔་འོད་དཀར་པོ་འབྱུང་བ་༔
K10sukhvysu:56	 citravarṇāni citranirbhāsāni citranidarśanāni śakaṭacakra-  pramāṇapariṇāhāni /	TZ21-ZHA-021:420	བཀྲ་བ་༔་ཁ་དོག་བཀྲ་བ་༔་འོད་བཀྲ་བ་འབྱུང་བ་༔་བཀྲ་བ་ལྟ་བུར་སྟོན་པ་༔་ཤིང་རྟའི་འཕང་ལོ་ཚམ་དུ་སྐྱེས་སོ་༔
K10sukhvysu:58	 evaṃrūpaiḥ śāriputra buddhakṣetraguṇavyūhaiḥ samalaṃkṛtaṃ  tadbuddhakṣetraṃ //4//	TZ21-ZHA-021:424	སངས་རྒྱས་ཀྱི་ཞིང་ཁམས་དེ་ལྟ་བུའི་ཡོན་ཏན་གྱིས་ལེགས་པར་བརྒྱན་པའི་ཞིང་ཡོད་དེ་༔
K10sukhvysu:60	 punar aparaṃ śāriputra tatra buddhakṣetre nityapravāditāni divyāni	TZ21-ZHA-021:425	བདག་ཀྱང་ཞིང་མཆོག་དེ་རུ་སྐྱེ་བར་ཤོག་ཅིག་༔་སྐྱེས་ནས་འོད་དཔག་མེད་ཀྱི་ཞལ་མཐོང་ཞིང་མཛད་པ་མཐའ་ཡས་པས་ས་ལམ་ཐམས་ཅད་རབ་ཏུ་རྫོགས་ནས་ཚཧེ་དཔག་མེད་ཀྱི་སྐུ་རུ་སངས་རྒྱས་པར་གྱུར་ཅིག་༔་འཇིག་རྟེན་གྱི་ཁམས་བདེ་བ་ཅན་དེ་ན་ལྷའི་སིལ་སྙན་གྱི་སྒྲ་རྟག་ཏུ་འབྱུང་ངོ་༔
K10sukhvysu:61	 tūryāṇi suvarṇavarṇā ca mahāpṛthivī ramaṇīyā /  tatra ca buddhakṣetre	TZ21-ZHA-021:428	ས་ཆེན་པོ་ནི་གསེར་གྱི་ཁ་དོག་ལྟ་བུ་སྟེ་ཉམས་དགའ་བའོ་༔
K10sukhvysu:63	 triṣkṛtvo rātrau triṣkṛtvo divasasya puṣpavarṣaṃ pravarṣati divyānāṃ  māṃdāravapuṣpāṇāṃ /	TZ21-ZHA-021:429	ཉིན་ལན་གསུམ་མཚཧན་ལན་གསུམ་མེ་ཏོག་གི་ཆར་འབབ་བོ་༔
K10sukhvysu:65	 tatra ye sattvā upapannās ta ekena purobhaktena  koṭiśatasahasraṃ buddhānāṃ vaṃdaṃty anyāṃl lokadhātūn gatvā / ekaikaṃ ca  tathāgataṃ koṭiśatasahasrābhiḥ puṣpavṛṣṭibhir abhyavakīrya punar api	TZ21-ZHA-021:430	སངས་རྒྱས་ཀྱི་ཞིང་དེར་སྐྱེས་པའི་འགྲོ་བ་དེ་རྣམས་སྔ་དྲོ་བཞིན་དུ་ཕྱོགས་བཅུའི་སངས་རྒྱས་ཀྱི་ཞིང་དུ་གཤེགས་ཏེ་སངས་རྒྱས་བྱེ་བ་ཕྲག་བརྒྱ་སྟོང་ལ་ཕྱག་འཚཧལ་ཞིང་དེ་བཞིན་གཤེགས་པ་རེ་རེ་ལ་མེ་ཏོག་ཆུན་བུ་བྱེ་བ་ཕྲག་བརྒྱ་སྟོང
K10sukhvysu:68	 tām eva lokadhātum āgacchaṃti divāvihārāya /	TZ21-ZHA-021:432	སླར་ཡང་རང་རང་གི་གདན་ལ་ལོག་ནས་ཏིང་ངེ་འཛིན་ལ་བཞུགས་སོ་༔
K10sukhvysu:69	 evaṃrūpaiḥ śāriputra  buddhakṣetraguṇavyūhaiḥ samalaṃkṛtaṃ tadbuddhakṣetraṃ //5//  punar aparaṃ śāriputra tatra buddhakṣetre saṃti haṃsāḥ kraiṃcā mayūrāś ca /  te triṣkṛtvo rātrau triṣkṛtvo divasasya saṃnipatya saṃgītiṃ kurvaṃti  sma svakasvakāni ca rutāni pravyāharaṃti /  teṣāṃ pravyāharatām  iṃdriyabalabodhyaṃgaśabdo niścarati /	TZ21-ZHA-021:433	ཞིང་ཁམས་དེ་རུ་ངང་པ་དང་༔་ཁྲུང་ཁྲུང་དང་༔་རྨ་བྱ་རྣམས་ཀྱིས་ཉིན་ལན་གསུམ་མཚཧན་ལན་གསུམ་དུ་འདུས་ནས་གླུ་དབྱངས་ལེན་ཅིང་རང་རང་གི་སྒྲ་སྐད་དུ་དབང་པོ་དང་༔་སྟོབས་དང་༔་བྱང་ཆུབ་ཀྱི་ཡན་ལག་གི་སྒྲ་འབྱུང་ངོ་༔
K10sukhvysu:76	 tatra teṣāṃ manuṣyāṇāṃ taṃ śabdaṃ	TZ21-ZHA-021:434	སེམས་ཅན་གང་དག་དེར་སྐྱེས་པ་དེ་དག་གིས་སྒྲ་དེ་ཐོས་ནས་༔
K10sukhvysu:77	 śrutvā buddhamanasikāra utpadyate dharmamanasikāra utpadyate saṃghamanasikāra	TZ21-ZHA-021:435	སངས་རྒྱས་ཡིད་ལ་བྱེད་པ་དང་༔་ཆོས་ཡིད་ལ་བྱེད་པ་དང་༔་དགེ་འདུན་ཡིད་ལ་བྱེད་པ་སྐྱེ་བར་འགྱུར་༔
K10sukhvysu:78	 utpadyate // tat kiṃ manyase śāriputra tiryagyonigatās te  sattvāḥ / na punar evaṃ draṣṭavyaṃ /	TZ21-ZHA-021:436	སེམས་ཅན་དེ་དག་ནི་དུད་འགྲོའི་སྐྱེ་གནས་སུ་གྱུར་པ་མ་ཡིན་ཏེ་༔
K10sukhvysu:80	 tat kasmād dhetoḥ /  tatra buddhakṣetre nirayāṇāṃ nāsti tiryagyonīnāṃ yamalokasya  nāsti / te punaḥ pakṣisaṃghās tenāmitāyuṣā tathāgatena nirmitā  dharmaśabdaṃ niścārayaṃti /	TZ21-ZHA-021:437	ཞིང་དེར་དུད་འགྲོའི་སྐྱེ་གནས་དང་༔་གཤིན་རྗེའི་འཇིག་རྟེན་དུ་སྐྱེ་བའི་མིང་ཡང་མེད་དེ་བྱའི་ཚཧོགས་དེ་རྣམས་ནི་དེ་བཞིན་གཤེགས་པ་ཚཧེ་དཔག་མེད་ཀྱིས་ཆོས་ཀྱི་སྒྲ་འབྱུང་བའི་ཕྱིར་དུ་སྤྲུལ་པ་ཤ་སྟག་གོ་༔
K10sukhvysu:90	 cāryaiḥ(2) saṃpravāditasya valgur manojñaḥ śabdo niścarati evam eva  śāriputra tāsāṃ ca tālapaṃktīnāṃ teṣāṃ ca kiṃkiṇījālānāṃ  vāteritānāṃ valgur manojñaḥ śabdo niścarati /	TZ21-ZHA-021:440	སངས་རྒྱས་ཀྱི་ཞིང་དེ་ན་ཏ་ལའི་ཕྲེང་བ་དེ་དག་དང་༔་དྲིལ་བུ་གཡེར་ཁའི་དྲྭ་བ་དེ་དག་ལ་རླུང་གིས་བསྐྱོད་ཅིང་ཕོག་ན་སྒྲ་སྙན་པ་ཡིད་དུ་འོང་བ་ཉམས་དགའ་བ་འབྱུང་བ་ལས་༔
K10sukhvysu:93	 tatra teṣāṃ manuṣyāṇāṃ  taṃ śabdaṃ śrutvā buddhānusmṛtiḥ kāye saṃtiṣṭhati dharmānusmṛtiḥ kāye	TZ21-ZHA-021:441	དེར་མི་དག་གིས་སྒྲ་ཐོས་ནས་སངས་རྒྱས་རྗེས་སུ་དྲན་པ་དང་༔་ཆོས་རྗེས་སུ་དྲན་པ་དང་༔་དགེ་འདུན་རྗེས་སུ་དྲན་པ་ལུས་ལ་གནས་སོ་༔
