src_segmentnr	src_original	tgt_segmentnr	tgt_original
K12mpratpru:125	 ity api ca bhagavān supravartitadharmacakraḥ supariniṣṭhitabuddhakāryaḥ suparipūrṇapuṇyajñānasaṃbhāraḥ	T02D2692:244a-4	སངས་རྒྱས་ཀྱི་མཛད་པ་ནི་ཤིན་ཏུ་མཐར་ཕྱིན་། བསོད་ནམས་དང་ཡེ་ཤེས་ཀྱི་ཚོགས་ནི་ཤིན་ཏུ་རྫོགས་།
K12mpratpru:126	 suparigṛhītasarvajñatāmahābodhipāramitābhūmilābhojjvalitadvātriṃśatmahāpuruṣalakṣaṇālaṃkṛtaśarīraś (Mp_4)	T02D2692:244a-6	ཐམས་ཅད་མཁྱེན་པ་ཉིད་ཀྱི་བྱང་ཆུབ་ཆེན་པོའི་ཕྱིར་ཕ་རོལ་ཏུ་ཕྱིན་པ་དང་། ས་བརྙེས་པ་ཤིན་ཏུ་ཡོངས་སུ་བཟུང་།
K12mpratpru:127	 caturaśītyanuvyañjanavirājitaḥ sarvāṅgāvayavaśobhaḥ sarvasatvānavalokitamūrdhānirjitaḥ	T02D2692:244a-7	སྤྱི་གཙུག་ནི་སེམས་ཅན་ཐམས་ཅད་ཀྱིས་བལྟ་བར་མི་མཐོང་།
K12mpratpru:128	 sarvamārakarmakovidaḥ sarvasatvajñānapañcavidhacakṣuḥ sarvākāravaropetaḥ sarvajñajñānasamanvāgataḥ	T02D2692:244a-8	བདུད་ཀྱི་ལས་ཐམས་ཅད་ལས་ནི་ངེས་པར་རྒྱལ་༏་དེ་ཁོ་ན་ཐམས་ཅད་མཁྱེན་པ་ནི་ཐུགས་སུ་ཆུད་། སྤྱན་ལྔ་ནི་མངའ། རྣམ་པ་ཐམས་ཅད་ཀྱི་མཆོག་དང་ནི་ལྡན་། ཐམས་ཅད་མཁྱེན་པའི་ཡེ་ཤེས་དང་ནི་ལྡན་།
K12mpratpru:129	 sarvabuddhadharmasamanvāgataḥ /	T02D2692:244a-13	སངས་རྒྱས་ཀྱི་ཆོས་ཐམས་ཅད་ནི་ལྡན་།
K12mpratpru:13	 caturaśītibhir bodhisatvakoṭīniyutaśatasahasraiḥ sārdham /	T02D2692:243a-21	བྱང་ཆུབ་སེམས་དཔའི་རིགས་མི་གཅིག་པ་བརྒྱ་སྟོང་འབུམ་གྱི་འཁོར་དང་བཅས་ཤིང་།
K12mpratpru:130	 sarvamāraparapramādikugaṇigaṇapramathana udgatakīrtiśabdaśloka ārṣabhasiṃhanādaṃnadī	T02D2692:244a-14	བདུད་དང་པས་ཀྱི་རྒོལ་བའི་ཚོགས་ཐམས་ཅད་ནི་བཅོམ་། དགྲ་དང་ལས་ནི་འཕགས་། ཁྱུ་མཆོག་དང་སེང་གེའི་སྒྲ་ནི་སྒྲོགས་།
K12mpratpru:131	 samucchinnāvidyāndhakāro	T02D2692:244a-17	མ་རིག་པའི་མུན་པ་ནི་ཀུན་དུ་བསལ་།
K12mpratpru:133	 mahāvajraratnapadmagarbhasiṃhāsane niṣaṇṇaḥ /	T02D2692:244a-20	མངོན་པར་འགྲུབ་པའི་སྐྱེས་བུ་ཆེན་པོའི་མཚན་སུམ་ཅུ་རྩ་གཉིས་དང་། དེ་བྱད་བཟང་པོ་བརྒྱད་ཅུས་བརྒྱན་པའི་སྐུ་མཛེས་ཤིང་།
K12mpratpru:134	 anekavajraratnavedikāsaṃskṛtapādapīṭhasupratiṣṭhite /  anekavajraratnamakaramukhodgīrṇalohitamuktāvalīnibaddhagandhāyake /  anekavajraratnamuktakiṅkiṇījālakalukalonnādite /  anekavajraratnaśalākāvibhūṣitoddaṇḍātapatrakoṭīniyutaśatasahasrakṛtacchāyāparikare /  anekakalpavṛṣadrumopaśobhitavistāre sumerumātre vajraratnapadmāsane niṣaṇṇaḥ /	T02D2692:244a-21	རིན་པོ་ཆེ་རྡོ་རྗེ་ཆེན་པོའི་པདམའི་སྙིང་པོ་སེང་གེའི་ཁྲི་ལ་བཞུགས་ཏེ་།
K12mpratpru:14	 sarvair ekajātibhir avaivartikair anuttarāyāṃ samyaksaṃbodhau mahāsthāmaprāptair mahāvajravimokṣasamādhibuddhakṣetravikurvaṇamahāprātihāryasaṃdarśakaiḥ	T02D2692:243a-22	བླ་ན་མེད་པ་ཡང་དག་པར་རྫོགས་པའི་བྱང་ཆུབ་ལས་ཕྱིར་མི་ལྡོག་པར་མཐུ་ཆེན་པོ་ཐོབ་པ་། རྡོ་རྗེ་ཆེན་པོའི་རྣམ་པར་ཐར་པ་དང་། ཏིང་ངེ་འཛིན་གྱི་སངས་རྒྱས་ཀྱི་ཞིང་དུ་རྣམ་པར་སྤྲུལ་པ་དང་། ཆོ་འཕྲུལ་ཀུན་དུ་སྟོན་པ་དང་། སེམས་ཀྱི་སྐད་ཅིག་ཐང་ཅིག་ཡུང་ཙམ་གཅིག་ལ་སེམས་ཅན་ཐམས་ཅད་ཀྱི་སེམས་དང་སྤྱོད་པའི་རྗེས་སུ་འཇུག་པའི་ཆོས་བསྟན་པ་སྣ་ཚོགས་མཉམ་པ་ཉིད་དུ་མཉམ་ཞིང་རྒྱ་ཆེ་ལ་ཟབ་པ་དང་།
K12mpratpru:140	 kāñcanaparvatarāja iva śriyā jvalanasūryasahasrābhir ekaprabhāmaṇḍalavirājita bhūmibhāgaḥ /	T02D2692:244a-22	གསེར་གྱི་རི་བོའི་རྒྱལ་པོ་ལྟར་དཔལ་ནི་འབར་། ས་ཕྱོགས་ནི་ཉི་མ་སྟེང་བས་ལྷག་པའི་འོད་ཟེར་གྱི་དཀྱིལ་འཁོར་གྱིས་རྣམ་པར་བརྒྱན་།
K12mpratpru:141	 suparipūrṇacandramaṇḍala iva sarvalokapriyadarśano mahākalpavṛkṣa iva buddhadharmaiḥ saṃkusumito dharmaṃ deśayati sma //	T02D2692:244a-24	ཟླ་བ་ཉ་གང་བ་ལྟ་ར་འཇིག་རྟེན་ཐམས་ཅད་ལ་ནི་སྡུག་པར་སྣང་།
K12mpratpru:15	 ekacitrakṣaṇabhavamuhūrtasarvasatvacittacaritānupraveśavicitramadhurodāragambhīradharmadeśanāpratibhānaprātihāryasaṃdarśakair  anekabuddhakṣetratathāgatamahāpūjameghārcanāvimokṣamukhadhāraṇīsamādhivaśitābhijñāvaeṇikabodhyaṅgamārgabhūmipāramitopāyakauśalyasaṃgrahavastramahāmaitrīkaruṇāmuditopekṣāmaitrībalaviviktaparyavadātacittasaṃtānaiḥ	T02D2692:243b-0	སྦོབས་པ་དང་། ཆོ་འཕྲུལ་དང་། ལྡན་པ་སངས་རྒྱས་ཀྱི་ཞིང་དུ་མར་དེ་བཞིན་གཤེགས་པ་ལ་མཆོད་པ་ཆེན་པོའི་སྤྲིན་གྱིས་མཆོད་པ་དང་། རྣམ་པར་ཐར་པའི་སྒོ་དང་། གཟུངས་དང་། ༄༢༤༣བ་ཏིང་ངེ་འཛིན་དང་། དབང་དང་། མངོན་པར་ཤེས་པ་དང་། མ་འདྲེས་པ་དང་། བྱང་ཆུབ་ཀྱི་ཡན་ལག་དང་། ལམ་དང་། ས་དང་། ཕ་རོལ་ཏུ་ཕྱིན་པ་དང་། ཐབས་ལ་མཁས་པ་དང་། བསྡུ་བའི་དངོས་པོ་དང་། བྱམས་པ་དང་། སྙིང་རྗེ་དང་། དགའ་བ་དང་། བཏང་སྙོམས་དང་། བྱམས་པའི་སྟོབས་དང་། དབེན་པ་དང་། ཡོངས་སུ་བྱས་པའི་སེམས་ཀྱི་རྒྱུན་དང་ལྡན་པ་ཤ་སྟག་གོ་༎
K12mpratpru:17	 tadyathā / vajragarbheṇa ca bodhisatvena mahāsatvena /  vajranetreṇa ca /  vajragātreṇa ca /  vajramatinā ca /  vajrahastena ca /  vajrasaṃhatena ca /  vajranārāyaṇena ca /  vajravikurvitena ca /	T02D2692:243b-3	བྱང་ཆུབ་སེམས་དཔའ་སེམས་དཔའ་ཆེན་པོ་ལག་ན་རྡོ་རྗེ་དང་། རྡོ་རྗེ་གཏུམ་པོ་དང་། རྡོ་རྗེ་སེམས་དཔའ་དང་། ལག་ན་རྡོ་རྗེ་མདའ་གཞུ་དང་༏་རྡོ་རྗེ་བྱིན་གྱིས་བརླབས་པ་དང་། རྡོ་རྗེའི་རྒྱན་དང་། རྡོ་རྗེའི་འོད་དང་།
K12mpratpru:26	 vajrarāśinā ca /  vajrāṅkuśena ca /  suvajreṇa ca /  vajrasenena ca /	T02D2692:243b-4	སྤྱན་རས་གཟིགས་དང་། ཀུན་དུ་བཟང་པོ་དང་། ཀུན་དུ་གཟིགས་པ་དང་། རྡོ་རྗེ་དཔལ་དང་། པདམ་འབྱུང་གནས་དང་། ཞལ་རྣམ་པར་མཆེ་བ་གཙིགས་པའི་རྡོ་རྗེ་དང་། པདམ་སྙིང་པོ་དང་། པདམའི་སྤྱན་དང་། འཇམ་དཔལ་དང་།
K12mpratpru:30	 vajraketunā ca bodhisatvena mahāsatvena //  evaṃ pramukhair bodhisatvakoṭīniyutaśatasahasraiḥ sārdhaṃ saṃbahulaiś ca mahāśrāvakaiḥ sarvair arhadbhir kṣīṇāsravair ucchinnabhavasaṃyojanaiḥ	T02D2692:243b-5	བྱང་ཆུབ་སེམས་དཔའ་སེམས་དཔའ་ཆེན་པོ་བྱམས་པ་ལ་སོགས་པ་བྱང་ཆུབ་སེམས་དཔའི་དགེ་འདུན་དང་ཐབས་ཅིག་གོ་༎ ཉན་ཐོས་ཆེན་པོ་རབ་ཏུ་མང་པོ་ཐམས་ཅད་ཀྱང་དགྲ་བཅོམ་པ་། ཟག་པ་ཟད་བ་༎ སྲིད་པར་ཀུན་དུ་སྦྱོར་བ་ཆད་པ་།
K12mpratpru:32	 samyagājñāsuvimuktacittaiḥ suvimuktaprajñair acintyasamādhibalaprātihāryavikurvaṇamahāsthāmaprāptair asaṅgajñānadarśibhiḥ /	T02D2692:243b-9	ཡང་དག་པའི་ཤེས་པས་སེམས་ཤིན་ཏུ་རྣམ་པར་གྲོལ་བ་། རྫུ་འཕྲུལ་གྱི་སྟོབས་དང་། ཆོ་འཕྲུལ་བསམ་གྱིས་མི་ཁྱབ་པ་རྣམ་པར་འཕྲུལ་པའི་མཐུ་ཆེན་པོ་ཐོབ་པ་། ལྟ་བ་ཆགས་པ་མེད་པ་།
K12mpratpru:33	 sarvair vigatamalair nidagdhasaṃkleśavāsanābījaiḥ //	T02D2692:243b-12	ཐམས་ཅད་ཀྱང་དྲི་མ་དང་བྲལ་བ་། ཀུན་ནས་ཉོན་མོངས་པའི་བག་ཆགས་ཀྱི་ས་བོན་བསྲེགས་བ་ཤ་སྟག་ལ་།
