src_segmentnr	src_original	tgt_segmentnr	tgt_original
K12sarvttsu:62	 sarvatathāgatān praṇipatyāhū yaivamāha- “bhagavantastathāgatā ājñāpayata kathaṃ pratipadyāmi kīdṛśaṃ tat tattvam” iti /	T02D2502:171b-5	བཅོམ་ལྡན་འདས་རྣམས་དེ་བཞིན་གཤེགས་པ་ཐམས་ཅད་ཀྱི་དེ་ཁོ་ན་ཉིད་ནི་ཇི་ལྟ་བུ་ལགས་། བདག་གིས་ནི་དེ་དག་ཇི་ལྟ་བུར་བསྒྲུབ་པར་བགྱི་ཞེས་གསོལ་བ་དང་། དེ་བཞིན་གཤེགས་པ་དེ་དག་གིས་འདི་སྐད་ཅེས་བཀའ་སྩལ་ཏོ་༎
K12sarvttsu:64	 svacittapratyavekṣaṇasamādhānena prakṛtisiddhena rucijaptena mantreṇa” iti oṃ cittaprativedhaṃ karomi /	T02D2502:171b-8	རང་བཞིན་གྱིས་གྲུབ་པའི་སྔགས་འདི་ཅི་དགར་བཟླ་ཞིང་ཡིད་ལ་གྱིས་ཤིག་། ཅེས་གསུངས་པའི་རིམ་གྱིས་རང་གི་སེམས་རྟོགས་པར་གྱུར་པའི་ཚེའམ་དུས་ན་།
K12sarvttsu:65	 atha bodhisattvaḥ sarvatathāgatānevamāha- “ājñātaṃ me bhagavantastathāgatāḥ svahṛdi candramaṇḍalākāraṃ paśyāmi” /	T02D2502:171b-9	དང་པོར་རང་གི་སེམས་ཉིད་ཟླ་བ་ལྟ་བུའི་རྣམ་པར་གནས་པར་མཐོང་བ་ལ་སོགས་པའི་རྣམ་པས་རྡོ་རྗེ་དབྱིངས་ཞེས་བྱ་བ་དེ་བཞིན་གཤེགས་པར་སངས་རྒྱས་པའི་ཚེའོ་༎ འོག་ནས་འབྱུང་བའི་ཆོ་ག་ཞེས་པ་ནི་དེ་ལྟར་སངས་རྒྱས་པའི་འཇིག་པའི་གོ་རིམས་ལ་ཆོ་ག་ཞེས་བྱ་སྟེ་། ཇི་ལྟར་འོག་ནས་འབྱུང་བའི་རིམ་པའོ་༎ དེ་བཞིན་གཤེགས་པ་རྣམས་ལ་འདི་སྐད་ཅེས་གསོལ་ཏོ་༎ བཅོམ་ལྡན་འདས་དེ་བཞིན་གཤེགས་པ་རྣམས་བདག་ཉིད་ཀྱི་སྙིང་ག་ན་རང་གི་སེམས་ཉིད་ཟླ་བའི་དཀྱིལ་འཁོར་གྱི་རྣམ་པ་ལྟ་བུར་གདའ་བར་མཐོང་ངོ་ཞེས་གསོལ་བ་དང་། དེ་བཞིན་གཤེགས་པ་རྣམས་ཀྱིས་བཀའ་སྩལ་བ་།
K12sarvttsu:66	 sarvatathāgatāḥ procuḥ- “prakṛtiprabhāsvaramidaṃ kulaputra cittaṃ,	T02D2502:172a-0	རིགས་ཀྱི་བུ་སེམས་འདི་ཉིད་རང་བཞིན་༄༡༧༢ཨ་༌་༎
K12sarvttsu:67	 tadyathā parikarṣyate tat tathaiva bhavati /	T02D2502:172a-1	གྱིས་འོད་གསལ་བས་ཇི་ལྟར་སྤྱངས་པ་བཞིན་དུ་འགྱུར་བ་སྟེ་།
K12sarvttsu:2009	 “santi bhagavantaḥ satvāḥ maheśvarā diduṣṭasa] tvā,	T02D2502:156b-15	ཅིའི་ཕྱིར་ཞེས་གསུངས་པ་དང་། བཅོམ་ལྡན་འདས་དབང་ཕྱུག་ཆེན་པོའི་ལ་སོགས་པ་ཁྲོ་ཞིང་མཐུ་ཆེ་བའི་སེམས་ཅན་མ་རུངས་པ་དག་ཀྱང་མཆིས་ཏེ་དེ་བཞིན་གཤེགས་པ་རྣམས་ཀྱིས་ཞི་བས་འདུལ་བར་མི་སྤྱོད་ན་།
K12sarvttsu:2010	 ye yuṣmābhirapi sarvatathāgatairavineyāḥ,  teṣāṃ mayā kathaṃ pratipattavyam/” //	T02D2502:156b-16	བདག་གིས་ཇི་ལྟར་བསྒྲུབ་པར་བགྱི་ཞེས་གསོལ་བ་དང་། བཅོམ་ལྡན་འདས་རྣམ་པར་སྣང་མཛད་མི་བསྐྱོད་པ་ལ་སོགས་པའི་དེ་བཞིན་གཤེགས་པ་ཐམས་ཅད་ཀྱིས་བྱིན་གྱི་རླབས་ཀྱིས་།
K12sarvttsu:2012	 atha bhagavān vairocanastathāgataḥ [sarvatathāga]tādhiṣṭhānena sarvatathāgatamahopāyajñānavajrannāma samādhiṃ samāpannaḥ /	T02D2502:156b-17	དེ་བཞིན་གཤེགས་པ་ཐམས་ཅད་ཀྱི་ཐབས་ཆེན་པོ་རྡོ་རྗེ་ཞེས་བྱ་བའི་ཏིང་ངེ་འཛིན་ལ་སྙོམས་པར་ཞུགས་ནས་།
K12sarvttsu:6539	 tathaiva japanmāsamekaṃ sādhayet /	T02D2502:305b-25	དེ་བཞིན་དུ་ཟླ་བ་གཅིག་ཏུ་སྒྲུབ་སྟེ་།
K12sarvttsu:6541	 tataḥ sarvakarmāṇi sidhyantī-“tyāha bhagavān vajradha]raḥ //  “atha karmāṇi bhavanti /	T02D2502:305b-28	དེ་ནས་ལས་རྣམས་འབྱུང་སྟེ་ཞེས་པ་ནི་། བསྲུང་བའི་ལས་འབྱུང་བ་སྟེ་།
K12sarvttsu:6543	 sakṛduccāritenātmaparagrāmanagararakṣa bhavati //	T02D2502:305b-30	ལན་ཅིག་བརྗོད་པས་ཞེས་པ་ནི་། བར་བྱ་བའི་གནས་ནི་འདི་དག་གོ་ཞེས་ལན་ཅིག་ཙམ་བརྗོད་ནས་། གོ་ཆའི་ཕྱག་རྒྱ་བཅིངས་ནས་སྔགས་བརྗོད་པ་ལ་སོགས་པའི་སྦྱོར་བ་བྱས་པ་ཙམ་གྱིས་བདག་དང་གཞན་དང་གྲོང་ཁྱེར་ལ་སོགས་པ་ཇི་ཙམ་འདོད་པའི་བསྲུང་བ་བྱས་པར་འགྱུར་རོ་༎
K12sarvttsu:6544	 kavacaba[ndhādināveśamapi kṛtvā candanagandhena grahāgraha]spṛṣṭavajrāṅku śaśarahastaratnasūryadhvajadantapaṅktipadmakhaḍgacakrajivhāsarvavajrakavacadaṃṣṭrāmuṣṭimudrādinisarvabhāvānāviśayati sakṛjjaptena //  māyākarma ca mayūrapatrapiñcchake vajraṃ cidhvā bandhayet /  tatastaṃ mayūrāṅgapiñcchakaṃ satvavajri mudra[yā badhyāt tā]vajjapedyāvat sarvatathāgatamudrā āviśati /	T02D2502:306a-3	དབབ་པ་། ནི་ཙནདན་གྱི་དྲི་ཞིམ་པོས་རེག་པ་དང་ཞེས་པ་སྔ་མ་བཞིན་དུ་ཙནདན་གྱི་ལྡེ་གུས་རེག་པ་དང་། རྡོ་རྗེ་ལྕགས་ཀྱུ་ལ་སོགས་པའི་ཕྱག་རྒྱ་དེ་དག་སྔ་མ་བཞིན་དུ་བྱས་ནས་ལན་ཅིག་བརྗོད་པས་འབབ་པར་འགྱུར་རོ་༎ རྡོ་རྗེ་ཐམས་ཅད་ལན་ཅིག་བཟླས་པས་ཞེས་པ་ནི་། ཕྱག་རྒྱ་དེ་དག་ནི་ཡེ་ཤེས་ཀྱི་ངོ་བོ་བས་རྡོ་རྗེ་དང་ཆོས་མཐུན་པའི་ཕྱིར་རོ་༎ སྒྱུ་མའི་ལས་སྒྲུབ་པའི་སྦྱོར་བའི་ཁྱད་པར་ནི་ཞེས་པ་ནི་། སྒྱུ་མའི་མིག་འཕྲུལ་སྒྲུབ་པའི་ཆོ་ག་བསྟན་པ་སྟེ་།
K12sarvttsu:6548	 tataḥ prabhṛti tena piñcchakena sarvarūpāṇi vidhivad darśayati /  tenaiva piñcchakena sakṛjjapte bhrāmitenātmanaḥ sarvarūpāṇi darśayati /	T02D2502:306a-10	དེ་ནས་རྡོ་རྗེ་སེམས་མའི་ཕྱག་རྒྱས་རྨ་བྱའི་མཇུག་མ་དེ་མནན་། དེ་ལ་ཕྱག་རྒྱ་ཐམས་ཅད་བབས་ཏེ་། ནམ་ཞུགས་པར་གྱུར་གྱི་བར་དུ་བཟླས་བརྗོད་བྱའོ་༎
K12sarvttsu:57	 atha khalu sarvatathāgatā mahāsamājamāpadya,  yena sarvārthasiddhirbodhisattvo mahāsattvaḥ bodhimaṇḍaniṣaṇṇastenopajagmuḥ /  upetya bodhisattvasya sāṃbhogikaiḥ kāyairdarśanandatvaivamāhuḥ- “kathaṃ kulaputrānuttarāṃ samyaksambodhim abhisaṃbhotsyase,	T02D2502:171b-2	དེ་བཞིན་གཤེགས་པ་ཐམས་ཅད་གཅིག་ཏུ་འདུས་ནས་དེའི་གང་དུ་གཤགས་ཏེ་ཆེད་དུ་ལོངས་སྤྱོད་རྫོགས་པའི་སྐུ་བསྟན་ནས་བྱང་ཆུབ་སེམས་དཔའ་དེ་ལ་མགྲིན་གཅིག་ཏུ་གསུང་མཐུན་པར་འདི་སྐད་ཅེས་གསུངས་སོ་༎
K12sarvttsu:2014	 sarvatathāgatasamatāmadhyālambhya,	T02D2502:157a-1	ནས་༏་དེ་བཞིན་གཤེགས་པའི་ཆོས་ལ་བདག་མེད་པའི་ཏིང་ངེ་འཛིན་ལ་དམིགས་ནས་།
K12sarvttsu:2015	 bhagavato vairocanasya śrīvatsahṛdaye praviṣṭāḥ /	T02D2502:157a-2	རྣམ་པར་སྣང་མཛད་ཀྱི་ཐུགས་ཀའི་དཔལ་བེའུར་ཞུགས་སོ་༎
K12sarvttsu:2016	 atha bhagavān vairocanastathāgataḥ sarvatathāgatahṛdayamātmānamadhiṣṭhāya sarvavajrasamatayā aśeṣānavaśeṣasatvadhātuparitrāṇasarvahitasukhottamasiddhihetoḥ sarvaduṣṭavinayāya ca,	T02D2502:157a-3	དེ་རྣམས་རྣམ་པར་སྣང་མཛད་ཀྱིས་སངས་རྒྱས་བཞི་པའི་ཐུགས་དང་བདག་གི་ཐུགས་ཐ་མི་དད་པར་བྱིན་གྱིས་བརླབས་ཏེ་། སེམས་ཅན་ཐམས་ཅད་ངན་སོང་ལས་བསྐྱབ་པ་དང་། ཚེ་འདི་ལ་ཕན་པ་དང་། ཕྱི་མ་ལ་བདེ་བ་དང་། བླ་ན་མེད་པའི་བྱང་ཆུབ་ཏུ་འགྲུབ་པར་བྱ་བའི་ཕྱིར་།
K12sarvttsu:2017	 sarvatathāgatamahākaruṇopāyasamādhijñānamadhyālambhya,	T02D2502:157a-5	དེ་བཞིན་གཤེགས་པའི་སྙིང་རྗེ་ཆེན་པོའི་ཐབས་ཀྱི་ཏིང་ངེ་འཛིན་ལ་དམིགས་ཏེ་།
K12sarvttsu:2018	 sarvatathāgatamahākarūṇopāyakrodhasamaya vajraṃ nāma samādhiṃ samāpannaḥ /	T02D2502:157a-6	དེ་བཞིན་གཤེགས་པའི་སྙིང་རྗེ་ཆེན་པོའི་ཐབས་ཀྱི་ཁྲོ་བོ་དམ་ཚིག་རྡོ་རྗེ་ཞེས་བྱ་བའི་ཏིང་ངེ་འཛིན་ལ་སྙོམས་པར་ཞུགས་སོ་༎
K12sarvttsu:60	 yastvaṃ sarvatathāgatatattvānabhijñatayā sarvaduḥkarāṇyutsahasī-?“ti /	T02D2502:171b-3	རིགས་ཀྱི་བུ་གང་གི་ཕྱིར་དེ་བཞིན་གཤེགས་པ་ཐམས་ཅད་ཀྱི་དེ་ཁོ་ན་ཉིད་མངོན་པར་རྟོགས་པ་མ་བྱས་པར་།
K12sarvttsu:61	 atha sarvārthasiddhirbodhisattvo mahāsatvassarvatathāgatacoditaḥsamānastata āsphānasamādhito vyutthāya,	T02D2502:171b-4	དཀའ་བ་སྤྱད་པ་ཐམས་ཅད་ལ་སྤྲོ་བ་བསྐྱེད་ཅིང་ཇི་ལྟར་བླ་ན་མེད་པ་ཡང་དག་པར་རྫོགས་པའི་བྱང་ཆུབ་ཏུ་མངོན་པར་རྫོགས་པར་བྱ་སྙམ་ཞེས་བཀའ་སྩལ་པ་དང་། བྱང་ཆུབ་སེམས་དཔའ་དོན་ཐམས་ཅད་གྲུབ་པ་དེ་བཞིན་གཤེགས་པ་དེ་དག་གིས་བསྐུལ་བའི་མཐུས་ཏིང་ངེ་འཛིན་དེ་ལས་བཞེངས་ཏེ་དེ་བཞིན་གཤེགས་པ་དེ་དག་ལ་ཕྱག་འཚལ་ནས་འདི་སྐད་ཅེས་གསོལ་ཏོ་༎
