src_segmentnr	src_original	tgt_segmentnr	tgt_original
T02rabhramu:24	 sarvam ātmanaḥ pāpaṃ bhagavataḥ purataḥ pratideśayāmi,	T02D3490:140a-4	སྡིག་པ་ཐམས་ཅད་བདག་གིས་སོ་སོར་བཤགས་སོ་༎
T02rabhramu:25	 sarvabuddhabodhisattvāryapṛthagjanānāṃ sarvakuśalam anumode,	T02D3490:140a-5	སངས་རྒྱས་དང་བྱང་ཆུབ་སེམས་དཔའ་དང་འཕགས་པ་སོ་སོའི་སྐྱེ་བོ་ཐམས་ཅད་ཀྱི་དགེ་བ་ཐམས་ཅད་ལ་རྗེས་སུ་ཡི་རང་ངོ་༎
T02rabhramu:26	 sarvaṃ cātmanaḥ kuśalam anuttarāyāṃ samyaksaṃbodhau pariṇāmayāmi. eṣo 'ham ā bodher	T02D3490:140a-6	བདག་གིས་དགེ་བ་ཐམས་ཅད་ནི་བླ་ན་མེད་པ་ཡང་དག་པར་རྫོགས་པའི་སངས་རྒྱས་སུ་ཡོངས་སུ་བསྔོ་བར་བགྱིའོ་༎
T02rabhramu:27	 buddhaṃ bhagavantaṃ śaraṇaṃ gacchāmi dvipadānām agryam. dharmaṃ śaraṇaṃ gacchāmi	T02D3490:140a-7	འདིར་བདག་བྱང་ཆུབ་མ་ཐོབ་ཀྱི་བར་དུ་རྐང་གཉིས་རྣམས་ཀྱི་མཆོག་སངས་རྒྱས་ལ་སྐྱབས་སུ་མཆིའོ་༎ ཡང་དག་པའི་ཆོས་རྣམས་ཀྱི་མཆོག་ཐེག་པ་ཆེན་པོའི་ཆོས་ལ་སྐྱབས་སུ་མཆིའོ་༎
T02rabhramu:28	 samagraṃ mahāyānam. saṃghaṃ śaraṇaṃ gacchāmy avaivartikabodhisattvagaṇam. aho batāham	T02D3490:140a-9	ཚོགས་རྣམས་ཀྱི་མཆོག་བྱང་ཆུབ་སེམས་དཔའ་ཕྱིར་མི་ལྡོག་པའི་ཚོགས་ལ་སྐྱབས་སུ་མཆིའོ་༎
T02rabhramu:29	 anuttarāṃ samyaksaṃbodhiṃ abhisaṃbudheya sarvasattvānām arthāya hitāya sukhāya yāvad  atyantaniṣṭhe nirvāṇe buddhabodhau pratiṣṭhāpanāya. eṣo 'ham anuttaraṃ bodhimārgam	T02D3490:140a-10	ཀྱེ་མ་བདག་བླ་ན་མེད་པ་ཡང་དག་པར་རྫོགས་པའི་བྱང་ཆུབ་ཏུ་མངོན་པར་རྫོགས་པར་སངས་རྒྱས་ནས་སེམས་ཅན་གྱི་དོན་དང་ཕན་པ་དང་། བདེ་བའི་ཕྱིར་ཇི་སྲིད་ཤིན་ཏུ་མི་གནས་པའི་མྱ་ངན་ལས་འདས་པའི་དབྱིངས་རྫོགས་པའི་བྱང་ཆུབ་ལ་རབ་ཏུ་དགོད་ཅིང་དྲང་བའི་ཕྱིར་འདིར་བདག་བླ་ན་མེད་པ་ཡང་དག་རྫོགས་པའི་བྱང་ཆུབ་ཀྱི་ལམ་ལ་བརྟེན་པར་བགྱིད་དེ་།
T02rabhramu:31	 āśrayāmi yad uta vajrayānam.  tataḥ sarvasattveṣu divyasukhopasaṃhārākārāṃ maitrīm,  sarvaduḥkhāpanayanākārāṃ karuṇām,	T02D3490:140a-11	འདི་ལྟར་རྡོ་རྗེའི་ཐེག་པའོ་༎ དེ་ནས་གསུམ་ལ་སྐྱབས་སུ་འགྲོ་བའི་ཚིགས་བཅད་བརྗོད་པར་བྱའོ་༎ དེ་ནས་སེམས་ཅན་ཐམས་ཅད་ལ་བདེ་བ་ཉེ་བར་སྡུད་པར་བྱེད་པ་ནི་བྱམས་པའོ་༎ སྡུག་བསྔལ་ཐམས་ཅད་སེལ་བར་བྱེད་པ་ནི་སྙིང་རྗེའོ་༎
T02rabhramu:34	 divyasukhāviyoganiyamākārāṃ muditām,	T02D3490:140a-15	མཐོ་རིས་ཀྱི་བདེ་བ་རྣམ་པར་སྦྱོར་བ་ངེས་པར་བྱེད་པ་ནི་དགའ་བའོ་༎
T02rabhramu:35	 kleśapratipakṣamārgopasaṃhārākārām upekṣāṃ ca bhāvayet. tataḥ sarvadharmān manasālambya vicārayet ḥ cittam evaitat tena tenākāreṇa bhrāntaṃ pratibhāsate yathāsvapne.	T02D3490:140a-16	ཉོན་མོངས་པའི་གཉེན་པོའི་ཕྱོགས་ཀྱི་ལམ་ཉེ་བར་སྡུད་པའི་བཏང་སྙོམས་རྣམས་བསྒོམ་པར་བྱའོ་༎ དེ་ནས་ཆོས་ཐམས་ཅད་ལ་ཡིད་ཀྱིས་དམིགས་ཏེ་རྣམ་པར་སྤྱད་པར་བྱའོ་༎ བསམ་པ་དེ་བཞིན་དུ་འདིར་དེ་དང་དེའི་རྣམ་པས་འཁྲུལ་པ་རྣམས་སོ་སོར་བསལ་ཏེ་དཔེར་ན་རྨི་ལམ་གྱི་སེམས་ལས་ཕྱི་རུ་ཡོད་པ་ལྟ་བུའོ་༎
T02rabhramu:36	 (BhrHe 159)  nāsti cittād bāhyaṃ cittagrāhyam. grāhyābhāvāc cittam api grāhakaṃ na bhavati. tasmāc cittaśarīrāḥ sarvadharmāḥ,	T02D3490:140a-19	སེམས་ཀྱི་ཕྱི་རོལ་དུ་གཟུང་བ་རང་བཞིན་མེད་པས་འཛིན་པའི་སེམས་ཀྱང་རང་བཞིན་མེད་པར་འགྱུར་རོ་༎
T02rabhramu:38	 teṣāṃ grāhyagrāhakaśūnyatā paramārtha iti. evam ekāntena niścitya bhrāntisamāropitaṃ  bhrānticihnaṃ sarvadharmāṇām ākāraṃ vihāya teṣāṃ prakṛtim eva kevalām advayavijñaptilakṣaṇāṃ	T02D3490:140a-20	དེ་ལ་སེམས་དང་ལུས་ཀྱི་ཆོས་ཐམས་ཅད་དེ་རྣམས་ཀྱིས་གཟུང་བ་དང་འཛིན་པ་སྟོང་པ་ཉིད་ཀྱིས་དོན་དམ་པ་ཞེས་བྱའོ་༎ དེ་བཞིན་དུ་གཅིག་གི་མཐའ་ཡས་ངེས་པ་དང་འཁྲུལ་པ་ཡང་དག་པར་སྐྱེ་བ་འཁྲུལ་པའི་རྟགས་ཆོས་ཐམས་ཅད་༄༡༤༠བ་ཀྱི་རྣམ་པར་སྤོང་བ་དེ་རྣམས་ཀྱི་རང་བཞིན་དེ་བཞིན་ཉིད་འབའ་ཞིག་པ་གཉིས་སུ་མེད་པ་དག་ཅིང་མཚན་ཉིད་ཤེལ་དག་པ
T02rabhramu:40	 śuddhasphaṭikasaṃkāśāṃ śaradamalamadhyāhnagaganopamām anantāṃ paśyet. idam ucyate	T02D3490:140b-1	ལྟ་བུ་སྟོན་ཀའི་དྲི་མ་མེད་པའི་ཉིན་གུང་གི་ནམ་མཁའ་ལྟ་བུ་མཐའ་ཡས་པ་བལྟ་བར་བྱའོ་༎
T02rabhramu:41	 pāramārthikaṃ bodhicittaṃ lokottaraṃ śūnyatājñānaṃ niṣprapañcaṃ nirvikalpam. tatas	T02D3490:140b-2	འདིར་འཇིག་རྟེན་ལས་འདས་པའི་སྟོང་པ་ཉིད་ཀྱི་ཡེ་ཤེས་སྤྲོས་པ་དང་བྲལ་བ་རྣམ་པར་མི་རྟོག་པར་གསུངས་སོ་༎
T02rabhramu:42	 tan mantreṇādhitiṣṭhet	T02D3490:140b-3	དེ་ནས་དེའི་སྔགས་ཀྱིས་བྱིན་གྱིས་བརླབ་པར་བྱའོ་༎
T02rabhramu:44	 saiva bhagavatī prajñāpāramitā,  saiva paramā rakṣā.	T02D3490:140b-5	བསྙེན་པ་ནི་བཅོམ་ལྡན་འདས་མ་ཤེས་རབ་ཀྱི་ཕ་རོལ་ཏུ་ཕྱིན་མ་བསྙེན་པའི་ཆོ་ག་བསྲུང་བར་བྱའོ་༎
T02rabhramu:46	 tatas tanniṣyandabhūtām ākāravatīṃ rakṣāṃ śuddhalaukikajñānasvabhāvāṃ bhāvayet.	T02D3490:140b-6	དེ་ནས་དེའི་མི་འཇིགས་པར་འགྱུར་པའི་རྣམ་པ་དང་ལྡན་པ་བསྲུང་ཤིང་དག་པ་འཇིག་རྟེན་པའི་ཡེ་ཤེས་ཀྱི་རང་བཞིན་བསྒོམ་པར་བྱའོ་༎
T02rabhramu:47	 repheṇa sūryaṃ purato vibhāvya tasmin ravau hūṃbhavaviśvavajram /	T02D3490:140b-7	དེ་ནས་ར་ཡིག་ལས་ནི་ཉི་མ་བདུན་དུ་བསྒོམ་༎ ཉི་མར་ཧའུམ་ཡིག་ལས་བྱུང་སྣ་ཚོགས་རྡོར་༎
T02rabhramu:48	 tenaiva vajreṇa vibhāvayec ca prākārakaṃ pañjarabandhanaṃ ca //	T02D3490:140b-9	དེ་ཡིས་དེ་བཞིན་རྡོ་རྗེ་རྣམ་བསྒོམས་ནས་༎ ར་བ་དང་ནི་གུར་ཡང་བཅིང་བར་བྱ་༎
T02rabhramu:49	 viśvavajrakiraṇaiḥ pralayānaladuḥsahaiḥ sarvataḥ spharitvā (BhrHe 160)	T02D3490:140b-11	སྣ་ཚོགས་རྡོ་རྗེའི་འོད་ཀྱིས་བསྐལ་པའི་མེ་ལྟར་བཟོད་པར་དཀའ་བས་ཐམས་ཅད་དུ་འཕྲོ་ཞིང་མཁྲེགས་པར་འགྱུར་བས་སྤྲས་པའོ་༎ འཕྲེང་དུ་གྲུ་བཞི་པ་འབར་བཞིན་པའི་རྡོ་རྗེའི་ར་བའོ་༎
T02rabhramu:51	 upariṣṭād vajrapañjaram,	T02D3490:140b-13	སྟེང་དུ་རྡོ་རྗེའི་གུར་རོ་༎
T02rabhramu:52	 adhastād vajramayīṃ bhūmim ārasātalaviracitāṃ paśyet. tato raviviśvavajrābhyāṃ raśmībhūya diśi diśi spharitvā ghanībhūya bahir dūre sīmābandhaḥ karaṇīya iti ślokārthaḥ.	T02D3490:140b-14	འོག་ཏུ་རྡོ་རྗེའི་རང་བཞིན་གྱིས་གཞིས་རོ་གདན་གྱི་འོག་ཀུན་དུ་རྣམ་པར་སྤྲས་པར་བལྟ་བར་བྱའོ་༎ དེ་ནས་ཉི་མ་དང་སྣ་ཚོགས་རྡོ་རྗེ་དག་ལས་འོད་ཟེར་བྱུང་ནས་ཕྱོགས་སུ་འཕྲོ་ཞིང་མཁྲེགས་པར་གྱུར་པས་ཕྱི་རུ་སྒོའི་མཚམས་བཅིང་པར་བྱའོ་ཞེས་པ་ནི་ཚིགས་སུ་བཅད་པའི་དོན་ཏོ་༎
T02rabhramu:53	 tatas tanniṣyandatayaiva viśuddhāni pañca mahābhūtāni cintayet. tatrākāśamahābhūtaṃ  dharmodayākhyaṃ mahāvajradharasvabhāvaṃ śaracchaśadharadhavalam adhaḥ sūkṣmam upari  viśālaṃ trikoṇam antar gaganasvarūpaṃ abhyantarodgataviśvadaIakamalakarṇikāvasthitavipulaviśvavajram.	T02D3490:140b-16	དེའི་དབུས་སུ་ནམ་མཁར་འབྱུང་བ་ཆེན་པོའི་རང་བཞིན་ཆོས་འབྱུང་ཞེས་བཤད་པ་རྡོ་རྗེ་ཆེན་པོ་འཛིན་པའི་རང་བཞིན་སྟོན་ཀའི་ཟླ་བ་ལྟར་དཀར་བ་སྨད་ཕྲ་ཞིང་སྟེང་ཡངས་པ་ཟུར་གསུམ་པ་ནམ་མཁའི་རང་བཞིན་ནོ་༎ དེའི་དབུས་སུ་སྣ་ཚོགས་ཆུ་སྐྱེས་ཀྱི་ཟེའུ་འབྲུལ་ལ་གནས་པའི་སྣ་ཚོགས་རྡོ་རྗེ་ཆེན་པོའོ་༎
T02rabhramu:56	 tadvedikāyāṃ catvāri mahābhūtāni caturmaṇḍalākārāṇi caturdevīsvabhāvāny upary upari	T02D3490:140b-18	དེའི་སྟེགས་བུ་ལ་འབྱུང་བ་ཆེན་པོ་བཞི་ལས་གྲུབ་པའི་དཀྱིལ་འཁོར་གྱི་རྣམ་པ་བཞི་པོ་ལྷ་མོ་བཞིའི་རང་བཞིན་རྣམས་ནི་སྟེང་དུ་ཡོངས་སུ་བལྟ་བར་བྱའོ་༎
T02rabhramu:57	 paśyet. ādau laṃkāreṇa māhendramaṇḍalaṃ caturasraṃ pītaṃ koṇeṣu triśūkavajrāṅkam.	T02D3490:140b-19	དེ་ལ་དང་པོ་ཡམ་ཡིག་ལས་རླུང་གཞུའི་རྣམ་པ་ནག་པོ་དུ་བའི་མདོག་ལྟ་བུ་རྩེ་མོ་གཉིས་ལ་ག-ཡོ་བའི་དན་གྱིས་བརྒྱན་པའོ་༎
T02rabhramu:58	 tato vaṃkāreṇa vāruṇaṃ vartulaṃ sitaṃ ghaṭāṅkam. tato raṃkāreṇāgneyaṃ trikoṇaṃ raktaṃ  koṇeṣu rephāṅkam. tato yaṃkāreṇa vāyavyaṃ dhanurākāraṃ kṛṣṇaṃ koṭidvaye calatpatākāṅkam.	T02D3490:140b-20	དེ་ནས་རམ་ཡིག་ལས་མེ་གྲུ་གསུམ་དམར༏་པོ་ཟུར་རྣམས་རམ་ཡིག་གིས་མཚན་པའོ་༎ དེ་ནས་བམ་ཡིག་ལས་ཆུ་དཀར་པོ་ཟླུམ་པོ་བུམ་པས་མཚན་པའོ་༎ དེ་ནས་ལམ་ཡིག་ལས་དབང་ཆེན་གྱི་དཀྱིལ་འཁོར་གྲུ་བཞི་སེར་པོ་ཟུར་རྣམས་སུ་རྡོ་རྗེ་༄༡༤༡ཨ་༌་༎ དེའི་སྟེང་དུ་བྷའུམ་ཡིག་ལས་སྐྱེས་པའི་འཁོར་ལོའོ་༎
T02rabhramu:60	 bhāvakas tu tadānīṃ tad eva lokottarajñānaṃ (BhrHe 161)  vyāpakatvena sthitam. tato viśvavajravedikāmadhye caturmahābhūtapariṇāmajaṃ pariśuddhabuddhakṣetrasaṃkṣeparūpaṃ	T02D3490:141a-3	དང་པོ་ནི་དེ་ལས་ངོ་བོ་ཉིད་ཀྱི་ལྷ་འཇིག་རྟེན་ལས་འདས་པའི་ཡེ་ཤེས་ཉིད་ཀྱིས་ཁྱབ་ཅིང་གནས་པ་། དེ་ནས་སྣ་ཚོགས་རྡོ་རྗེའོ་༎
T02rabhramu:62	 mahāmokṣapuraṃ vairocanasvabhāvaṃ nānāratnamayaṃ kūṭāgāram aṣṭābhiḥ śmaśānaiḥ sarvalokadhātunairātmyasūcakaiḥ parivṛtaṃ dhyāyāt.	T02D3490:141a-5	སྟེགས་བུའི་དབུས་སུ་འབྱུང་བ་ཆེན་པོ་བཞི་ཡོངས་སུ་གྱུར་པ་ལས་སྐྱེས་པ་ཡོངས་སུ་དག་པའི་སངས་རྒྱས་ཀྱི་ཞིང་བསྡུས་པའི་གཟུགས་ཐར་པའི་གྲོང་ཁྱེར་ཆེན་པོ་རྣམ་པར་སྣང་མཛད་ཀྱི་རང་བཞིན་རིན་པོ་ཆེ་སྣ་ཚོགས་པའི་རང་བཞིན་གྱི་གཞལ་ཡས
T02rabhramu:63	 caturasraṃ caturdvāram aṣṭastambhopaśobhitam /	T02D3490:141a-6	ཁང་གྲུ་བཞི་སྒོ་བཞི་པ་།
